Time – Die Zeit ~ Die Zeiten
Man – Der Man ~ Die Männer
Hand – Die Hand ~ Die Hände
Day – Der Tag ~ Die Tagen
Way – Der Weg ~ Die Wege
Eye – Das Auge ~ Die Augen
Thing – Das Ding ~ Die Dinge
Head – Der Kopf ~ Die Köpfe
Year – Das Jahr ~ Die Jahre
Room – Der Raum ~ Die Räume
Door – Die Tür ~ Die Türen
Woman – Die Frau ~ Die Frauen
Face – Das Gesicht ~ Die Gesichter
Mother – Die Mutter ~ Die Mütter
People – Das Volk ~ Die Völker
Night – Die Nacht ~ Die Nächte
House – Das Haus ~ Die Häuser
Father – Der Vater ~ Die Väter
Life – Das Leben ~ Die Leben
Back – Der Rücken ~ Die Rücken
Voice – Die Stimme ~ Die Stimmen
Girl – Das Mädchen ~ Die Mädchen
Place – Der Ort ~ Die Orte
Boy – Der Junge ~ Die Jungen
Car – Das Auto ~ Die Autos
Side – Die Seite ~ Die Seiten
Arm – Der Arm ~ Die Arme
Child – Das Kind ~ Die Kinder
Word – Das Wort ~ Die Worte
Moment – Der Moment ~ Die Momente
Hair – Das Haar ~ Die Haare
Foot – Der Fuß ~ Die Füße
Water – Das Wasser ~ Die Wasser
Light – Das Licht ~ Die Lichter
World – Die Welt ~ Die Welt
Name – Der Name ~ Die Namen
Friend – Der Freund ~ Die Freunde
Window – Das Fenster ~ Die Fenster
Body – Der Körper ~ Die Körper
Table – Der Tisch ~ Die Tabellen
Morning – Der Morgen ~ Die Morgen
Bed – Das Bett ~ Die Betten
Wall – Die Mauer ~ Die Wände
Street – Die Straße ~ Die Straßen
School – Die Schule ~ Die Schulen
Air – Die Luft ~ Die Lüfte
Floor – Der Boden ~ Die Böden
Hour – Die Stunde ~ Die Stunden
End – Das Ende ~ Die Enden
Family – Die Familie ~ Die Familien
Guy – Der Kerl ~ Die Kerle
Kind – Die Art ~ Die Arten
Minute – Die Minute ~ Die Minuten
Story – Die Geschichte ~ Die Geschichten
God – Der Gott ~ Die Götter
Week – Die Woche ~ Die Wochen
Work – Die Arbeit ~ Die Werke
Shoulder – Die Schulter ~ Die Schultern
Part – Der Teil ~ Die Teile
Mind – Der Geist ~ Die Gemüter
Book – Das Buch ~ Die Bücher
Finger – Der Finger ~ Die Finger
Mouth – Der Mund ~ Die Mündungen
Kid – Das Kind ~ Die Kinder
Glass – Das Glas ~ Die Brille
Tree – Der Baum ~ Die Bäume
Sound – Der Klang ~ Die Geräusche
Line – Die Linie ~ Die Linien
Wife – Die Ehefrau ~ Die Ehefrauen
Heart – Das Herz ~ Die Herzen
Money – Das Geld ~ Die Gelder
Phone – Das Telefon ~ Die Telefone
Look – Das Aussehen ~ Die Blicke
Leg – Das Bein ~ Die Beine
Chair – Der Stuhl ~ Die Stühle
Office – Das Büro ~ Die Büros
Brother – Der Bruder ~ Die Brüder
Question – Die Frage ~ Die Fragen
City – Die Stadt ~ Die Städte
Month – Der Monat ~ Die Monate
Baby – Das Baby ~ Die Babys
Home – Das Zuhause ~ Die Häuser
Dog – Der Hund ~ Die Hunde
Road – Die Straße ~ Die Straßen
Idea – Die Idee ~ Die Ideen
Kitchen – Die Küche ~ Die Küchen
Lot – Das Los ~ Die Lose
Son – Der Sohn ~ Die Söhne
Job – Der Beruf ~ Die Jobs
Paper – Das Papier ~ Die Papiere
Sister – Die Schwester ~ Die Schwestern
Smile – Das Lächeln ~ Die Lächeln
Point – Der Punkt ~ Die Punkte
Thought – Der Gedanke ~ Die Gedanken
Love – Die Liebe ~ Die Liebe
Town – Die Stadt ~ Die Städte
Death – Der Tod ~ Die Todesfälle
Ground – Der Boden ~ Die Gründe
Others – Die Anderen ~ Die Anderen
Fire – Das Feuer ~ Die Feuer
Step – Der Schritt ~ Die Schritte
Blood – Das Blut ~ Die Blut
Fact – Die Tatsache ~ Die Fakten
Breath – Der Atem ~ Die Atem
Lip – Die Lippe ~ Die Lippen
Sun – Die Sonne ~ Die Sonnen
Building – Gebäude ~ Die Gebäude
Number – Die Anzahl ~ Die Nummern
Husband – Der Ehemann ~ Die Ehemänner
Parent – Das Elternteil ~ Die Eltern
Corner – Die Ecke ~ Die Ecken
Problem – Das Problem ~ Die Probleme
Couple – Das Ehepaar ~ Die Paare
Daughter – Die Tochter ~ Die Töchter
Bag – Der Beutel ~ Die Taschen
Hell – Die Hölle ~ Die Höllen
Rest – Die Rast ~ Die Reste
Business – Das Geschäft ~ Die Unternehmen
Sky – Der Himmel ~ Der Himmel
Box – Die Kiste ~ Die Boxs
Person – Die Person ~ Die Personen
Reason – Der Grund ~ Die Gründe
Right – Das Recht ~ Die Rechte
Skin – Die Haut ~ Die Häute
Dad – Der Vater ~ Die Väter
Case – Der Fall ~ Die Fälle
Piece – Das Stück ~ Die Stücke
Doctor – Der Doktor ~ Die Doktoren
Edge – Die Ecke ~ Die Kanten
Mom – Die Mama ~ Die Mütter
Picture – Das Bild ~ Die Bilder
Sense – Der Sinn ~ Die Sinne
Ear – Das Ohr ~ Die Ohren
Second – Der Zweite ~ Die Sekunden
Lady – Die Dame ~ Die Damen
Neck – Der Hals ~ Die Hälse
Wind – Der Wind ~ Die Winde
Desk – Der Schreibtisch ~ Die Schreibtische
Gun – Die Waffe ~ Die Waffen
Stone – Der Stein ~ Die Steine
Coffee – Der Kaffee ~ Die Kaffee
Ship – Das Schiff ~ Die Schiffe
Earth – Die Erde ~ Die Erden
Food – Das Essen ~ Die Lebensmittel
Horse – Das Pferd ~ Die Pferde
Field – Das Feld ~ Die Felder
War – Der Krieg ~ Die Kriege
Afternoon – Der Nachmittag ~ Die Nachmittage
Sir – Die Sir ~ Die Damen Und Herren
Space – Der Raum ~ Die Räume
Evening – Der Abend ~ Die Abende
Letter – Der Brief ~ Die Briefe
Bar – Die Bar ~ Die Bars
Dream – Der Traum ~ Die Träume
Apartment – Die Wohnung ~ Die Wohnungen
Chest – Die Brust ~ Die Truhen
Game – Das Spiel ~ Die Spiele
Summer – Der Sommer ~ Die Sommer
Matter – Der Grund ~ Die Angelegenheiten
Silence – Die Stille ~ Die Stille
Top – Die Spitze ~ Die Spitzen
Rock – Der Fels ~ Die Steine
Power – Die Macht ~ Die Befugnisse
Clothes – Die Kleider ~ Die Clotheses
Sign – Das Schild ~ Die Zeichen
Attention – Die Aufmerksamkeit ~ Die Aufmerksamkeit
Music – Die Musik ~ Die Musiken
State – Der Staat ~ Die Staaten
Pocket – Die Tasche ~ Die Taschen
Dinner – Das Abendessen ~ Die Abendessen
Hall – Die Halle ~ Die Hallen
Pain – Der Schmerz ~ Die Schmerzen
Age – Das Alter ~ Das Alter
River – Der Fluss ~ Die Flüsse
Chance – Die Chance ~ Die Chancen
Nose – Die Nase ~ Die Nasen
Shadow – Der Schatten ~ Die Schatten
Police – Die Polizei ~ Die Politiken
Memory – Das Gedächtnis ~ Die Erinnerungen
Color – Die Farbe ~ Die Farben
Knee – Das Knie ~ Die Knie
Wood – Das Holz ~ Der Wald
Shirt – Das Hemd ~ Die Hemden
Party – Die Party ~ Die Parteien
Country – Das Land ~ Die Länder
Truck – Der Lkw ~ Die Lastwagen
Tooth – Der Zahn ~ Die Tooths
Bill – Die Rechnung ~ Die Rechnungen
Scene – Die Szene ~ Szenen
Land – Das Land ~ Die Ländereien
Star – Der Stern ~ Die Sterne
Bird – Der Vogel ~ Die Vögel
Bedroom – Das Schlafzimmer ~ Die Schlafzimmer
Uncle – Der Onkel ~ Die Onkel
Sort – Die Art ~ Die Sorten
Group – Die Gruppe ~ Die Gruppen
Truth – Die Wahrheit ~ Die Wahrheiten
Trouble – Die Schwierigkeiten ~ Die Probleme
Crowd – Die Menge ~ Die Menschenmengen
Station – Der Bahnhof ~ Die Stationen
Tear – Die Reiß ~ Die Tränen
Class – Die Klasse ~ Die Klassen
Sea – Das Meer ~ Die Meere
Animal – Das Tier ~ Die Tiere
Center – Das Zentrum ~ Die Zentren
Feeling – Das Gefühl ~ Die Gefühle
Store – Das Geschäft ~ Die Läden
Mountain – Der Berg ~ Die Berge
News – Die Nachrichten ~ Die Newses
Shoe – Der Schuh ~ Die Schuhe
Cat – Die Katze ~ Die Katzen
Screen – Der Bildschirm ~ Die Schirme
Bottle – Die Flasche ~ Die Flaschen
Call – Der Anruf ~ Die Anrufe
Living – Die Lebenden ~ Die Livings
Cheek – Die Wange ~ Die Wangen
Student – Der Schüler ~ Die Studenten
Ball – Der Ball ~ Die Bälle
Sight – Die Sehenswürdigkeit ~ Die Sehenswürdigkeiten
Hill – Der Hügel ~ Die Hügel
Company – Das Unternehmen ~ Die Betriebe
Church – Die Kirche ~ Die Kirchen
Rain – Der Regen ~ Die Regenzeit
Suit – Der Anzug ~ Die Anzüge
One – Der Eine ~ Die Einen
Direction – Die Richtung ~ Die Richtungen
Will – Der Wille ~ Die Testamente
Throat – Der Hals ~ Die Kehlen
Middle – Die Mitte ~ Die Middles
Answer – Die Antwort ~ Die Antworten
Stuff – Das Zeug ~ Die Stoffe
Hospital – Das Krankenhaus ~ Die Krankenhäuser
Camera – Die Kamera ~ Die Kameras
Dress – Das Kleid ~ Die Kleider
Card – Die Karte ~ Die Karten
Yard – Der Hof ~ Die Werften
Dark – Die Dunkelheit ~ Die Dunkelheiten
Shit – Die Scheiße ~ Die Scheiße
Image – Das Bild ~ Die Bilder
Machine – Die Maschine ~ Die Maschinen
Distance – Die Distanz ~ Die Abstände
Area – Das Gebiet ~ Die Bereiche
Narrator – Der Erzähler ~ Die Erzähler
Ice – Das Eis ~ Die Ices
Snow – Der Schnee ~ Der Schnee
Note – Die Notiz ~ Die Notizen
Mirror – Der Spiegel ~ Die Spiegel
King – Der König ~ Die Könige
Fear – Die Angst ~ Die Ängste
Officer – Der Offizier ~ Die Offiziere
Hole – Das Loch ~ Die Löcher
Shot – Der Schuss ~ Die Schüsse
Guard – Der Wächter ~ Die Wachen
Conversation – Die Unterhaltung ~ Die Gespräche
Boat – Das Boot ~ Die Boote
System – Das System ~ Die Systeme
Care – Die Pflege ~ Die Sorgen
Bit – Die Bit ~ Die Bits
Movie – Der Film ~ Kino
Bone – Der Knochen ~ Die Knochen
Page – Die Seite ~ Die Seiten
Captain – Der Kapitän ~ Die Kapitäne
Aunt – Die Tante ~ Die Tanten
Darkness – Dunkelheit ~ Die Dunkelheiten
Control – Die Kontrolle ~ Die Steuerelemente
Drink – Das Getränk ~ Die Getränke
Hotel – Das Hotel ~ Die Hotels
Coat – Der Mantel ~ Die Mäntel
Stair – Die Treppen ~ Die Treppe
Order – Die Bestellung ~ Die Aufträge
Rose – Die Rose ~ Die Rosen
Miss – Der Fehl ~ Die Fehlschüsse
Hat – Der Hut ~ Die Hüte
Gold – Das Gold ~ Die Goldmedaillen
Cigarette – Die Zigarette ~ Die Zigaretten
Cloud – Die Wolke ~ Die Wolken
View – Die Aussicht ~ Die Ansichten
Driver – Der Fahrer ~ Die Fahrer
Cup – Die Tasse ~ Die Tassen
Figure – Die Figur ~ Die Figuren
Expression – Der Ausdruck ~ Die Ausdrücke
Path – Der Pfad ~ Die Wege
Key – Der Schlüssel ~ Die Schlüssel
Computer – Der Computer ~ Die Computer
Flower – Die Blume ~ Die Blumen
Ring – Der Ring ~ Die Ringe
Bathroom – Das Bad ~ Die Badezimmer
Metal – Das Metall ~ Die Metalle
Moon – Der Mond ~ Die Monde
Song – Das Lied ~ Die Lieder
Soldier – Der Soldat ~ Die Soldaten
Radio – Das Radio ~ Die Funkgeräte
History – Die Geschichte ~ Die Geschichten
Wave – Die Welle ~ Die Wellen
Plan – Der Plan ~ Die Pläne
College – Das College ~ Die Fachhochschulen
Fish – Der Fisch ~ Die Fische
Garden – Der Garten ~ Die Gärten
Train – Der Zug ~ Die Züge
Shop – Das Geschäft ~ Die Läden
Cop – Der Polizist ~ Die Polizisten
Art – Die Kunst ~ Die Künste
Beer – Das Bier ~ Die Biere
North – Norden ~ Die Norths
Island – Die Insel ~ Die Inseln
Bus – Der Bus ~ Die Busse
Smell – Der Geruch ~ Die Gerüche
Noise – Das Geräusch ~ Die Geräusche
Mama – Die Mama ~ The Mamas
Park – Der Park ~ Die Parks
South – Der Süden ~ Die Souths
Pair – Das Paar ~ Die Paare
Lord – Der Herr ~ Die Herren
Plate – Der Teller ~ Die Platten
Jacket – Die Jacke ~ Die Jacken
Help – Die Hilfe ~ Die Hilft
Daddy – Der Papa ~ Die Väter
Grass – Das Gras ~ Die Gräser
Thanks – Die Dank ~ Die Thankses
Heat – Die Hitze ~ Die Heats
Sleep – Der Schlaf ~ Die Schlafplätze
Brain – Das Gehirn ~ Die Gehirne
Service – Der Service ~ Der Dienstleistungen
Trip – Die Reise ~ Die Ausflüge
Beat – Der Beat ~ Die Beats
Knife – Das Messer ~ Die Messer
Spot – Der Platz ~ Die Flecken
Message – Die Nachricht ~ Die Nachrichten
Mark – Die Note ~ Die Noten
Teacher – Der Lehrer ~ Die Lehrer
Gaze – Der Blick ~ Die Blicke
Village – Das Dorf ~ Die Dörfer
Winter – Der Winter ~ Die Winter
Front – Die Front ~ Die Fronten
Law – Das Gesetz ~ Die Gesetze
Surface – Die Oberfläche ~ Die Oberflächen
Bank – Die Bank ~ Die Banken
Team – Das Team ~ Die Teams
Maximum – Das Maximum ~ Die Maxima
Position – Die Position ~ Die Positionen
Stomach – Der Bauch ~ Die Mägen
Turn – Die Wende ~ Die Windungen
West – Der Westen ~ Die Wests
Lunch – Das Mittagessen ~ Die Mittagessen
Change – Der Wechsel ~ Die Veränderungen
Creature – Die Kreatur ~ Geschöpfe
Soul – Die Seele ~ Die Seelen
Leaf – Das Blatt ~ Die Blätter
Show – Die Show ~ Die Shows
Gate – Die Gate ~ Die Tore
Palm – Die Palme ~ Die Handflächen
Plastic – Der Kunststoff ~ Die Kunststoff
Force – Die Kraft ~ Die Kräfte
Beach – Der Strand ~ Die Strände
President – Der Präsident ~ Die Präsidenten
Shape – Die Form ~ Die Formen
Smoke – Der Rauch ~ Die Raucht
Wheel – Das Rad ~ Die Räder
Silver – Das Silber ~ Die Silber
Roof – Das Dach ~ Die Dächer
Weight – Das Gewicht ~ Die Gewichte
Tongue – Die Zunge ~ Die Zungen
Tea – Der Tee ~ Die Tees
Track – Die Strecke ~ Die Spuren
Angle – Der Winkel ~ Die Winkel
Form – Die Form ~ Formen
Tone – Der Ton ~ Die Töne
Circle – Der Kreis ~ Die Kreise
Spring – Der Frühling ~ Die Federn
Porch – Die Vorhalle ~ Die Veranden
Sheet – Das Blatt ~ Die Blätter
Member – Das Mitglied ~ Die Angehörigen
Pool – Das Schwimmbecken ~ Die Pools
Need – Das Bedürfnis ~ Die Bedürfnisse
Hope – Die Hoffnung ~ Die Hoffnungen
Lake – Der See ~ Die Seen
Breast – Die Brust ~ Die Brüste
Surprise – Die Überraschung ~ Die Überraschungen
Interest – Die Interesse ~ Die Interessen
Bottom – Der Boden ~ Die Böden
Spirit – Der Geist ~ Die Geister
Block – Der Block ~ Die Blöcke
Language – Die Sprache ~ Die Sprachen
Bridge – Die Brücke ~ Die Brücken
Dust – Staub ~ Die Stäube
Cell – Die Zelle ~ Die Zellen
Wine – Wein ~ Die Weine
Boot – Das Boot ~ Die Stiefel
Choice – Die Wahl ~ Die Entscheidungen
Row – Die Reihe ~ Die Reihen
Talk – Das Gespräch ~ Die Gespräche
Plane – Das Flugzeug ~ Die Flugzeuge
Watch – Die Uhr ~ Die Uhren
Information – Die Information ~ Die Informationen
Grandmother – Die Großmutter ~ Die Großmütter
Wing – Der Flügel ~ Die Flügel
Bob – Die Bob ~ Die Bobs
Club – Der Club ~ Die Vereine
Master – Der Meister ~ Die Meister
Grace – Die Gnade ~ Die Gnaden
Forest – Der Wald ~ Die Wälder
Size – Die Größe ~ Die Größen
Set – Der Satz ~ Die Sätze
Marriage – Die Ehe ~ Die Ehen
Forehead – Die Stirn ~ Die Stirn
Storm – Sturm ~ Die Stürme
Doorway – Die Türöffnung ~ Die Türen
Situation – Die Situation ~ Die Situationen
Counter – Der Zähler ~ Die Zähler
Neighbor – Der Nachbar ~ Die Nachbarn
Photo – Das Foto ~ Die Fotos
Stage – Die Bühne ~ Die Stufen
Meeting – Das Treffen ~ Die Sitzungen
Nurse – Die Krankenschwester ~ Die Krankenschwestern
Security – Die Sicherheit ~ Die Wertpapiere
Weapon – Die Waffe ~ Waffen
Event – Das Ereignis ~ Die Events
Ceiling – Die Decke ~ Die Decken
Engine – Der Motor ~ Die Motoren
Gift – Das Geschenk ~ Die Geschenke
Restaurant – Das Restaurant ~ Die Restaurants
Board – Die Tafel ~ Die Bretter
Hallway – Der Flur ~ Die Flure
Army – Die Armee ~ Die Armeen
Effort – Der Aufwand ~ Bemühungen
East – Der Osten ~ Die Easts
Agent – Der Agent ~ Die Mittel
Future – Die Zukunft ~ Die Futures
Pant – Die Hose ~ Die Hose
Leather – Das Leder ~ Die Leder
Flight – Der Flug ~ Die Flüge
Sex – Das Geschlecht ~ Die Sexs
Court – Das Gericht ~ Die Gerichte
Course – Der Kurs ~ Die Kurse
Dirt – Der Dreck ~ Die Dirts
Egg – Das Ei ~ Die Eier
Chin – Das Kinn ~ Die Kinne
Stranger – Der Fremde ~ Die Fremden
Pleasure – Die Freude ~ Die Freuden
Detail – Das Detail ~ Die Details
Crew – Die Besatzung ~ Die Besatzungen
Fall – Der Herbst ~ Die Wasserfälle
Guest – Der Gast ~ Die Gäste
Experience – Das Erlebnis ~ Erfahrungen
Joke – Der Witz ~ Die Witze
Sand – Der Sand ~ Der Sand
Fist – Die Faust ~ Die Fäuste
Action – Die Aktion ~ Die Aktionen
Walk – Das Wandern ~ Die Wanderungen
Wedding – Die Hochzeit ~ Die Hochzeiten
Deal – Der Deal ~ Die Angebote
Nature – Die Natur ~ Die Natur
Planet – Der Planet ~ Die Planeten
Cousin – Der Cousin ~ Die Cousinen
Movement – Die Bewegung ~ Die Bewegungen
Flesh – Das Fleisch ~ Die Konkretisiert
Record – Der Datensatz ~ Datensätze
Camp – Das Camp ~ Die Lager
Newspaper – Die Zeitung ~ Die Zeitung
Ray – Der Strahl ~ Die Strahlen
Human – Der Mensch ~ Die Menschen
Couch – Das Sofa ~ Die Liegen
Motion – Die Bewegung ~ Die Bewegungen
Grandfather – Der Großvater ~ Die Großväter
Photograph – Die Fotografie ~ Die Photographes
Secret – Das Geheimnis ~ Geheimnisse
Beauty – Die Schönheit ~ Die Schönheiten
Presence – Das Vorhandensein ~ Die Präsenzen
Bell – Die Glocke ~ Die Glocken
Folk – Die Volks ~ Die Leute
Button – Der Knopf ~ Die Knöpfe
List – Die Liste ~ Die Listen
Level – Das Level ~ Die Niveaus
Date – Das Datum ~ Die Daten
Subject – Das Thema ~ Die Fächer
Difference – Der Unterschied ~ Die Unterschiede
Pause – Die Pause ~ Die Pausen
Van – Der Van ~ Die Wagen
Blade – Die Klinge ~ Die Klingen
Television – Das Fernsehen ~ Die Fernseher
Cover – Die Titelseite ~ Die Abdeckungen
Past – Die Vergangenheit ~ Die Vergangenheit
Farm – Der Bauernhof ~ Die Bauernhöfe
Lap – Die Runden ~ Die Runden
Band – Die Band ~ Die Bands
Lawyer – Der Anwalt ~ Die Anwälte
Magazine – Das Magazin ~ Die Zeitschriften
Branch – Der Ast ~ Die Zweige
Frame – Der Rahmen ~ Die Rahmen
Deck – Das Deck ~ Die Decks
Effect – Der Effekt ~ Die Effekte
Dance – Der Tanz ~ Die Tänze
Vision – Die Sicht ~ Die Visionen
Ghost – Das Gespenst ~ Die Geister
Ass – Der Esel ~ Die Esel
Character – Der Charakter ~ Die Charaktere
Glance – Der Blick ~ Die Blicke
GoodBye – Das Auf Wiedersehen ~ Die Verabschiedungen
Parking – Das Park ~ Die Parkplätze
Breakfast – Das Frühstück ~ Das Frühstück
Gesture – Die Geste ~ Die Gesten
Luck – Das Glück ~ Die Lucks
Blanket – Die Decke ~ Die Decken
Gas – Das Gas ~ Die Gase
Corridor – Der Korridor ~ Die Flure
Professor – Der Professor ~ Die Professoren
Play – Das Spiel ~ Die Spiele
Mistake – Der Fehler ~ Die Fehler
University – Die Universität ~ Die Universitäten
Ocean – Der Ozean ~ Die Ozeane
Century – Das Jahrhundert ~ Die Jahrhunderte
Honey – Der Honig ~ Honige
Pile – Der Stapel ~ Die Pfähle
Bowl – Die Schale ~ Die Schalen
Base – Basis ~ Die Basen
Fence – Der Zaun ~ Die Zäune
Rule – Die Regel ~ Die Regeln
Laughter – Das Gelächter ~ Die Gelächter
Anger – Die Wut ~ Die Angers
Sweat – Der Schweiß ~ Die Schweißausbrüche
Accident – Der Unfall ~ Die Unfälle
Weather – Das Wetter ~ Die Wind Und Wetter
Decision – Die Entscheidung ~ Die Entscheidungen
Angel – Der Engel ~ Die Engel
Strength – Die Stärke ~ Die Stärken
Chicken – Das Huhn ~ Die Hühner
Study – Die Studium ~ Die Studien
Tape – Das Band ~ Die Bänder
Wrist – Das Handgelenk ~ Die Handgelenke
Stop – Der Halt ~ Die Anschläge
Hip – Die Hüfte ~ Die Hüften
Government – Die Regierung ~ Die Regierungen
Belly – Der Bauch ~ Die Bäuche
Queen – Die Königin ~ Die Königinnen
Report – Bericht ~ Die Berichte
Tail – Der Schweif ~ Die Schwänze
Plant – Die Pflanze ~ Die Pflanzen
Flame – Die Flamme ~ Die Flammen
Heaven – Der Himmel ~ Die Himmel
Belt – Der Gürtel ~ Die Gürtel
Neighborhood – Die Nachbarschaft ~ Die Nachbarschaften
Energy – Die Energie ~ Die Energien
Green – Das Grün ~ Die Grünen
Quarter – Das Viertel ~ Die Viertel
Enemy – Der Feind ~ Die Feinde
Move – Die Bewegung ~ Die Züge
Entrance – Der Eingang ~ Die Zugänge
Library – Die Bibliothek ~ Die Bibliotheken
Writer – Der Verfasser ~ Die Autoren
Peace – Der Frieden ~ Die Peaces
Touch – Die Berührung ~ Die Berührungen
Pot – Der Topf ~ Die Töpfe
Type – Der Typ ~ Die Typen
Cause – Der Grund ~ Die Gründe
Rope – Das Seil ~ Die Seile
Muscle – Der Muskel ~ Die Muskeln
Painting – Das Gemälde ~ Die Gemälde
Curtain – Die Gardine ~ Die Vorhänge
Meal – Die Mahlzeit ~ Die Essen
Act – Der Akt ~ Die Handlungen
Wolf – Der Wolf ~ Die Wölfe
Cabin – Die Kajüte ~ Die Kabinen
Charge – Die Ladung ~ Die Ladungen
Clock – Die Uhr ~ Die Uhren
Passenger – Der Passagier ~ Die Passagiere
Buddy – Der Kumpel ~ Die Freunde
Drug – Das Medikament ~ Die Arzneimittel
Use – Die Verwendung ~ Die Verwendungen
Bench – Die Bank ~ Die Bänke
Traffic – Der Verkehr ~ Die Verkehre
Relief – Das Relief ~ Die Reliefs
Cap – Die Kappe ~ Die Kappen
Pack – Das Rudel ~ Die Packungen
Weekend – Das Wochenende ~ Die Wochenenden
Stand – Der Stand ~ Die Stände
Elevator – Der Aufzug ~ Die Aufzüge
Birthday – Der Geburtstag ~ Die Geburtstage
Lily – Die Lilie ~ Die Lilien
Iron – Das Bügeleisen ~ Die Eisen
Meat – Das Fleisch ~ Das Fleisch
Eyebrow – Die Augenbraue ~ Die Augenbrauen
Response – Die Antwort ~ Die Antworten
Speed – Die Geschwindigkeit ~ Die Geschwindigkeiten
Purpose – Die Absicht ~ Die Zwecke
Skirt – Der Rock ~ Die Röcke
Square – Das Quadrat ~ Die Quadrate
Drive – Die Fahrt ~ Die Antriebe
Article – Den Artikel ~ Die Artikel
English – Das Englisch ~ Die Englishes
Tower – Der Turm ~ Die Türme
Battle – Der Kampf ~ Die Schlachten
Film – Der Film ~ Die Filme
Race – Das Rennen ~ Die Rennen
Shock – Der Schock ~ Die Schocks
Section – Die Sektion ~ Die Abschnitte
Manner – Die Methode ~ Die Sitten
Sword – Das Schwert ~ Die Schwerter
Stick – Der Stock ~ Die Stöcke
File – Die Datei ~ Die Dateien
Bread – Das Brot ~ Die Brote
Oil – Das Öl ~ Die Öle
Chain – Die Kette ~ Die Ketten
Department – Die Abteilung ~ Die Abteilungen
Project – Projekt ~ Die Projekte
Murder – Der Mord ~ Die Morde
Bear – Der Bär ~ Die Bären
Test – Der Test ~ Die Tests
Visit – Der Besuch ~ Die Besuche
Milk – Die Milch ~ Die Milch
Boss – Der Chef ~ Die Bosse
Elbow – Der Ellbogen ~ Die Ellbogen
Desire – Das Verlangen ~ Die Wünsche
Patient – Der Patient ~ Die Patienten
Grin – Das Grinsen ~ Die Grins
Lover – Der Liebhaber ~ Die Liebhaber
Price – Der Preis ~ Die Preise
Map – Die Karte ~ Die Karten
Knowledge – Das Wissen ~ Die Erkenntnisse
Beginning – Der Anfang ~ Die Anfänge
Cold – Die Kälte ~ Die Erkältung
Closet – Der Schrank ~ Die Schränke
Dawn – Die Morgendämmerung ~ Im Morgengrauen
Temple – Der Tempel ~ Die Tempel
Joy – Der Spaß ~ Die Freuden
Duty – Die Pflicht ~ Die Aufgaben
Practice – Die Übung ~ Die Praktiken
Heel – Die Ferse ~ Die Fersen
Valley – Das Tal ~ Die Täler
Fight – Der Kampf ~ Die Kämpfe
Wire – Das Kabel ~ Die Drähte
Jeans – Die Jeans ~ Die Jeanses
Kiss – Der Kuss ~ Die Küsse
Jaw – Der Kiefer ~ Die Backen
Run – Die Lauf ~ Die Läufe
Hold – Der Halt ~ Die Laderäume
Relationship – Das Verhältnis ~ Die Beziehungen
Object – Das Objekt ~ Die Objekte
Attack – Der Angriff ~ Die Angriffe
Dish – Das Gericht ~ Das Geschirr
Highway – Die Autobahn ~ Die Autobahnen
Shade – Die Schattierung ~ Die Schatten
Crime – Das Verbrechen ~ Die Verbrechen
White – Das Weiß ~ Die Weißen
Partner – Der Partner ~ Die Partner
Priest – Der Priester ~ Die Priester
Lawn – Der Rasen ~ Der Rasen
Laugh – Das Lachen ~ Die Lachen
Trunk – Der Kofferraum ~ Die Stämme
Cry – Das Weinen ~ Die Schreie
Program – Das Programm ~ Die Programme
Ride – Die Fahrt ~ Die Fahrten
Shelf – Das Regal ~ Die Regale
Gentleman – Der Gentleman ~ The Gentlemans
Being – Das Sein ~ Die Wesen
Steel – Der Stahl ~ Die Stähle
Sidewalk – Der Bürgersteig ~ Die Bürgersteige
Uniform – Die Uniform ~ Die Uniformen
Pattern – Das Muster ~ Die Muster
Evidence – Der Beweis ~ Die Beweise
Player – Der Spieler ~ Die Spieler
Novel – Der Roman ~ Die Romane
Pillow – Das Kissen ~ Die Kissen
Lamp – Die Lampe ~ Die Lampen
Drawer – Die Schublade ~ Die Schubladen
Danger – Die Gefahr ~ Die Gefahren
Detective – Der Detektiv ~ Die Detektive
Instant – Die Instant ~ Die Zeitpunkte
Thinking – Das Denken ~ Die Gedanken
Crack – Der Riss ~ Die Risse
Prayer – Das Gebet ~ Die Gebete
Towel – Das Handtuch ~ Die Handtücher
Glove – Der Handschuh ~ Die Handschuhe
Bay – Die Bucht ~ Die Buchten
Audience – Das Publikum ~ Das Publikum
Can – Die Dose ~ Die Dosen
Condition – Die Bedingung ~ Die Bedingungen
Trail – Der Pfad ~ Die Wanderwege
Waist – Die Taille ~ Die Taille
Pressure – Der Druck ~ Die Drücke
Telephone – Das Telefon ~ Die Telefone
Sink – Das Waschbecken ~ Die Waschbecken
Return – Die Rückkehr ~ Die Renditen
Breeze – Die Brise ~ Die Lüfte
Taste – Der Geschmack ~ Die Geschmäcker
Fault – Der Fehler ~ Die Fehler
Stream – Der Strom ~ Bäche
Result – Das Ergebnis ~ Die Ergebnisse
Author – Der Autor ~ Die Autoren
Tip – Das Trinkgeld ~ Die Spitzen
Shower – Die Dusche ~ Die Duschen
Toe – Die Zehe ~ Die Zehen
Season – Die Jahreszeit ~ Die Jahreszeiten
Half – Die Hälfte ~ Die Hälften
Fool – Der Dummkopf ~ Die Narren
Tunnel – Der Tunnel ~ Die Tunnel
Client – Der Klient ~ Die Clients
Garage – Die Garage ~ Die Garagen
Mission – Die Mission ~ Die Missionen
Chief – Der Chef ~ Die Häuptlinge
Bullet – Die Kugel ~ Die Kugeln
Market – Der Markt ~ Die Märkte
Loss – Der Verlust ~ Die Verluste
Series – Die Reihe ~ Die Serieses
Pen – Der Stift ~ Die Stifte
Term – Der Begriff ~ Die Begriffe
Poem – Das Gedicht ~ Die Gedichte
Prince – Der Prinz ~ Die Fürsten
Clay – Der Ton ~ Die Tone
Lock – Das Schloss ~ Die Schlösser
Reality – Die Realität ~ Die Wirklichkeiten
Snake – Die Schlange ~ Die Schlangen
Apple – Der Apfel ~ Die Äpfel
Mask – Die Maske ~ Die Masken
Customer – Dem Kunden ~ Die Kunden
Birth – Die Geburt ~ Die Geburten
Break – Die Pause ~ Die Pausen
Wonder – Das Wunder ~ Wunder
Sunlight – Das Sonnenlicht ~ Die Sunlights
Tank – Der Panzer ~ Die Tanks
Staff – Das Personal ~ Die Mitarbeiter
Lie – Die Lüge ~ Die Lügen
Faith – Der Glaube ~ Die Glaubensrichtungen
Honor – Die Ehre ~ Ehrungen
Cream – Die Creme ~ Die Cremes
Sake – Das Wohl ~ Die Willen
Victim – Das Opfer ~ Die Opfer
Possibility – Die Möglichkeit ~ Die Möglichkeiten
Contact – Der Kontakt ~ Die Kontakte
Mood – Die Stimmung ~ Die Stimmungen
Thumb – Der Daumen ~ Die Daumen
Reading – Das Lesen ~ Die Messwerte
Fun – Der Spaß ~ Die Funs
Candle – Die Kerze ~ Die Kerzen
Cave – Die Höhle ~ Die Höhlen
Post – Die Post ~ Die Pfosten
Prison – Das Gefängnis ~ Die Gefängnisse
Emotion – Die Emotion ~ Die Emotionen
Leader – Der Führer ~ Die Führer
Degree – Der Grad ~ Grade
Feature – Die Eigenschaft ~ Die Funktionen
Ticket – Das Ticket ~ Die Tickets
Alien – Das Alien ~ Die Aliens
Lesson – Der Unterricht ~ Die Stunden
Desert – Die Wüste ~ Die Wüsten
Cut – Der Schnitt ~ Die Schnitte
Mess – Die Unordnung ~ Die Kasinos
Warning – Die Warnung ~ Die Warnungen
Tale – Das Märchen ~ Die Geschichten
Funeral – Das Begräbnis ~ Die Beerdigungen
Cab – Das Taxi ~ Die Kabinen
Reporter – Der Reporter ~ Die Reporter
Present – Das Geschenk ~ Die Geschenke
Theater – Das Theater ~ Die Theater
Length – Die Länge ~ Die Längen
Mud – Der Schlamm ~ Die Schlämme
Science – Die Wissenschaft ~ Die Wissenschaften
Drop – Der Fall ~ Die Tropfen
String – Die Schnur ~ Die Streicher
Speech – Die Rede ~ Die Reden
Copy – Die Kopie ~ Die Kopien
Cow – Die Kuh ~ Die Kühe
Worker – Der Arbeiter ~ Die Arbeiter
Thigh – Der Oberschenkel ~ Die Thighes
Lab – Das Labor ~ Die Labore
Roll – Die Rolle ~ Die Walzen
Fruit – Das Obst ~ Die Früchte
Patch – Der Patch ~ Die Patches
Silk – Die Seide ~ Die Seide
Buck – Der Buck ~ Die Böcke
Brick – Die Ziegel ~ Die Ziegel
Rifle – Das Gewehr ~ Die Gewehre
Career – Die Karriere ~ Die Karrieren
Issue – Das Thema ~ Die Probleme
Opportunity – Die Gelegenheit ~ Die Chancen
Director – Der Direktor ~ Die Direktoren
Monster – Das Monster ~ Die Monster
Vehicle – Das Fahrzeug ~ Die Fahrzeuge
Alley – Die Gasse ~ Die Gassen
Sleeve – Die Hülse ~ Die Ärmel
Grave – Das Grab ~ Die Gräber
Bush – Der Busch ~ Die Büsche
Dining – Der Speisesaal ~ Die Dinings
Opening – Die Eröffnung ~ Die Öffnungen
Twin – Der Zwilling ~ Die Zwillinge
Barn – Die Scheune ~ Die Scheunen
Pound – Das Pfund ~ Die Pfunde
Site – Der Standort ~ Die Websites
Flash – Der Blitz ~ Die Blitze
Judge – Der Richter ~ Die Richter
Mass – Die Masse ~ Die Massen
Process – Der Prozess ~ Die Prozesse
Tie – Das Band ~ Die Bande
Purse – Der Geldbeutel ~ Die Geldbeutel
Pipe – Das Rohr ~ Die Röhren
Dragon – Der Drache ~ Die Drachen
Horizon – Der Horizont ~ Die Horizonte
Tray – Die Schale ~ Die Traies
Envelope – Der Umschlag ~ Die Umschläge
Check – Die Prüfung ~ Die Kontrollen
Adult – Die Erwachsene ~ Die Erwachsenen
Emergency – Der Notfall ~ Die Emergencys
Material – Das Material ~ Die Materialien
Childhood – Die Kindheit ~ Die Kindheit
Habit – Die Angewohnheit ~ Die Gewohnheiten
Artist – Der Künstler ~ Die Artisten
Address – Die Adresse ~ Die Adressen
Scent – Der Duft ~ Die Düfte
Universe – Das Universum ~ Die Universen
Nod – Das Kopfnicken ~ Die Nickt
Shell – Die Muschel ~ Die Schalen
Community – Die Gemeinde ~ Die Gemeinden
Start – Der Anfang ~ Beginnt Der
Wound – Die Wunde ~ Die Wunden
Mouse – Die Maus ~ Die Mäuse
Pilot – Der Pilot ~ Die Piloten
Grade – Die Klasse ~ Die Noten
Video – Das Video ~ Die Videos
Basket – Der Korb ~ Die Körbe
Wagon – Der Wagen ~ Die Wagen
Attempt – Der Versuch ~ Die Versuche
Sofa – Das Sofa ~ Die Sofas
Cake – Der Kuchen ~ Die Kuchen
Fellow – Der Kerl ~ Die Kerle
Affair – Die Affäre ~ Die Angelegenheiten
Shore – Die Küste ~ Die Ufer
General – Die Allgemeine ~ Die Generäle
Root – Der Ursprung ~ Die Wurzeln
Robe – Die Robe ~ Die Gewänder
Concern – Die Sorge ~ Die Bedenken
Press – Die Presse ~ Die Pressen
Rat – Die Ratte ~ Die Ratten
Society – Die Gesellschaft ~ Die Gesellschaften
Style – Der Stil ~ Die Stile
County – Die Kreis ~ Die Landkreise
Command – Der Befehl ~ Die Befehle
Visitor – Der Besucher ~ Die Besucher
Model – Das Model ~ Die Modelle
Chamber – Die Kammer ~ Die Kammern
Beast – Das Biest ~ Die Tiere
Bunch – Das Bündel ~ Die Trauben
Background – Der Hintergrund ~ Die Hintergründe
Unit – Die Einheit ~ Die Einheiten
Furniture – Die Möbel ~ Die Möbel
Nail – Der Nagel ~ Die Nägel
Scream – Der Schrei ~ Die Schreie
Property – Die Eigenschaft ~ Eigenschaften
Equipment – Die Ausrüstung ~ Die Ausrüstungen
Driveway – Die Auffahrt ~ Die Einfahrten
Grip – Der Griff ~ Die Griffe
Tube – Das Rohr ~ Die Röhren
Ash – Die Asche ~ Die Asche
Fan – Der Fan ~ Die Fans
Opinion – Die Meinung ~ Die Ansichten
Data – Die Daten ~ Die Daten
Connection – Die Verbindung ~ Die Verbindungen
Trick – Der Trick ~ Die Tricks
Mystery – Das Mysterium ~ Die Geheimnisse
Period – Die Periode ~ Die Perioden
Writing – Das Schreiben ~ Die Schriften
Horror – Der Horror ~ Die Schrecken
Candy – Die Süßigkeit ~ Die Bonbons
Bitch – Die Bitch ~ Die Hündinnen
Health – Die Gesundheit ~ Die Healths
Manager – Der Geschäftsführer ~ Die Manager
Safety – Die Sicherheit ~ Die Sicherheiten
Height – Die Höhe ~ Die Höhen
Appearance – Die Erscheinung ~ Die Erscheinungen
Sigh – Der Seufzer ~ Die Sighes
Mine – Die Mine ~ Die Bergwerke
Cloth – Die Kleidung ~ Die Tücher
Reaction – Die Reaktion ~ Die Reaktionen
Source – Die Quelle ~ Die Quellen
Self – Das Ich ~ Die Selfs
Pistol – Die Pistole ~ Die Pistolen
Airport – Der Flughafen ~ Die Flughäfen
Hero – Der Held ~ Die Helden
Promise – Das Versprechen ~ Die Versprechen
Bow – Der Bogen ~ Die Bögen
Tent – Das Zelt ~ Die Zelte
Booth – Der Messestand ~ Die Stände
Cash – Das Geld ~ Die Kassen
Avenue – Die Straße ~ Die Alleen
TShirt – Das TShirt ~ Die TShirts
Carpet – Der Teppich ~ Die Teppiche
Basement – Der Keller ~ Die Keller
Girlfriend – Die Freundin ~ Die Freundinnen
Beard – Der Bart ~ Die Bärte
Brow – Die Stirn ~ Die Augenbrauen
Display – Der Bildschirm ~ Die Anzeigen
Signal – Das Signal ~ Die Signale
Servant – Der Diener ~ Die Diener
Whisper – Das Flüstern ~ Das Flüstern
Doubt – Der Zweifel ~ Die Zweifel
Account – Das Konto ~ Die Accounts
Magic – Die Magie ~ Die Magie
Hank – Die Hank ~ Die Stränge
Limb – Das Glied ~ Die Schenkel
Bastard – Der Bastard ~ Die Bastarde
Skull – Der Schädel ~ Die Schädel
Sentence – Der Satz ~ Die Sätze
Collar – Der Kragen ~ Die Kragen
Horn – Das Horn ~ Die Hörner
Oak – Die Eiche ~ Die Eichen
Ankle – Der Knöchel ~ Die Knöchel
Doll – Die Puppe ~ Die Puppen
Sandwich – Das Sandwich ~ Die Sandwiches
Robin – Das Rotkehlchen ~ Die Rotkehlchen
Justice – Die Justiz ~ Die Richter
Pride – Der Stolz ~ Die Rudel
Youth – Die Jugend ~ Die Jugendlichen
Secretary – Der Sekretär ~ Die Sekretäre
Research – Die Forschung ~ Die Forschungen
Sport – Der Sport ~ Die Sport
Task – Die Aufgabe ~ Die Aufgaben
Grant – Der Zuschuss ~ Die Zuschüsse
Sheriff – Der Sheriff ~ Die Sheriffs
Midnight – Die Mitternachts ~ Die Mitternächte
Chip – Der Chip ~ Die Chips
Theory – Die Theorie ~ Theorien
Alarm – Den Wecker ~ Die Alarme
Collection – Die Sammlung ~ Die Sammlungen
Cross – Das Kreuz ~ Die Kreuze
Pine – Die Kiefer ~ Die Kiefern
Generation – Die Generation ~ Die Generationen
Authority – Die Autorität ~ Die Behörden
Papa – Die Papa ~ Die Papas
Journey – Die Reise ~ Die Reisen
Pearl – Die Perle ~ Die Perlen
Toilet – Die Toilette ~ Die Toiletten
Killer – Der Mörder ~ Die Mörder
Tool – Das Werkzeug ~ Die Werkzeuge
Medicine – Die Medizin ~ Die Medikamente
Sugar – Der Zucker ~ Die Zucker
Princess – Die Prinzessin ~ Die Prinzessinnen
Argument – Das Argument ~ Die Argumente
Cliff – Die Klippe ~ Die Klippen
Cart – Der Wagen ~ Die Wagen
Crystal – Der Kristall ~ Die Kristalle
Bean – Die Bohne ~ Die Bohnen
Cage – Der Käfig ~ Die Käfige
Chocolate – Die Schokolade ~ Die Pralinen
Coast – Die Küste ~ Die Küsten
Decade – Das Jahrzehnt ~ Die Jahrzehnte
Meaning – Die Bedeutung ~ Die Bedeutungen
Gear – Das Getriebe ~ Die Zahnräder
Suitcase – Der Koffer ~ Die Koffer
Operation – Die Operation ~ Die Operationen
Breathing – Das Atem ~ Die Breathings
Role – Die Rolle ~ Die Rollen
Version – Die Version ~ Fassungen
Prisoner – Der Gefangene ~ Die Gefangenen
Match – Das Match ~ Die Spiele
Beam – Der Strahl ~ Die Strahlen
Castle – Die Burg ~ Die Schlösser
Rush – Der Ansturm ~ Die Binsen
Lane – Die Fahrspur ~ Die Bahnen
Clothing – Die Bekleidung ~ Die Garnituren
Pole – Der Pol ~ Die Pole
Freedom – Die Freiheit ~ Die Freiheiten
Skill – Das Können ~ Die Fähigkeiten
Passion – Die Leidenschaft ~ Die Leidenschaften
Activity – Die Aktivität ~ Die Aktivitäten
Fuck – Zum Teufel ~ Die Fickt
Platform – Die Platform ~ Die Plattformen
Salt – Das Salz ~ Die Salze
Bike – Das Fahrrad ~ Die Fahrräder
Stack – Der Stapel ~ Die Stapel
Companion – Der Begleiter ~ Die Gefährten
Fate – Das Schicksal ~ Die Schicksale
Rage – Die Wut ~ Die Wütet
Supply – Die Versorgung ~ Die Lieferungen
Whale – Der Wal ~ Die Wale
Pig – Das Schwein ~ Die Schweine
Rabbit – Der Hase ~ Die Hasen
Aisle – Der Gang ~ Die Gänge
Monitor – Der Bildschirm ~ Die Monitore
Helmet – Der Helm ~ Die Helme
Respect – Der Respekt ~ Die Beziehung
Excitement – Die Aufregung ~ Die Aufregungen
Lobby – Die Lobby ~ Die Lobbys
Boyfriend – Der Freund ~ Die Freunde
Fur – Das Fell ~ Die Felle
Range – Der Bereich ~ Die Bereiche
Dick – Die Dick ~ Die Schwänze
Code – Der Code ~ Die Codes
Chapter – Das Kapitel ~ Die Kapitel
Reflection – Die Reflexion ~ Die Reflexionen
Mail – Die Post ~ Die EMails
Fly – Der Flug ~ Die Fliegen
Cabinet – Das Kabinett ~ Die Schränke
Toy – Das Spielzeug ~ Die Spielzeuge
Baseball – Die Baseball ~ The Baseballs
Inside – Das Innere ~ Die Innenseiten
Pace – Die Geschwindigkeit ~ Die Schritte
Handle – Der Griff ~ Die Griffe
Lead – Die Führung ~ Die Zuleitungen
Amount – Die Summe ~ Die Beträge
Nerve – Der Nerv ~ Die Nerven
Terror – Der Schrecken ~ Die Schrecken
Sweater – Der Pullover ~ Die Pullover
Quality – Die Qualität ~ Die Qualitäten
Hunter – Der Jäger ~ Die Jäger
Paint – Die Farbe ~ Die Anstriche
Buster – Die Buster ~ The Busters
Cotton – Die Baumwolle ~ Die Baumwollstoffe
Sergeant – Der Wachtmeister ~ Die Feldwebel
Credit – Der Kredit ~ Die Kredite
Blow – Der Schlag ~ Die Schläge
Devil – Der Teufel ~ Die Teufel
Threat – Die Bedrohung ~ Die Drohungen
Success – Der Erfolg ~ Erfolge
Eve – Dem Vorabend ~ Die Eves
Cable – Das Kabel ~ Die Kabel
Pan – Die Pfanne ~ Die Pfannen
Clerk – Der Angestellte ~ Die Schreiber
Title – Den Titel ~ Die Titel
Meter – Das Messgerät ~ Die Zähler
Shame – Die Schande ~ Die Schande
Needle – Die Nadel ~ Die Nadeln
Lung – Die Lunge ~ Die Lungen
Warrior – Der Krieger ~ Die Krieger
Circumstance – Der Umstand ~ Die Umstände
Studio – Das Studio ~ Die Studios
Panic – Die Panik ~ Die Panik
Lack – Der Mangel ~ Das Fehlt
Farmer – Der Bauer ~ Die Bauern
Accent – Der Akzent ~ Die Akzente
Bomb – Die Bombe ~ Die Bomben
Panel – Die Platte ~ Die Paneele
Ability – Die Fähigkeit ~ Die Das Können
Fortune – Das Glück ~ Die Geschicke
Victor – Der Sieger ~ Die Sieger
Feather – Die Feder ~ Die Federn
Grandma – Die Oma ~ Die Großmütter
Glow – Das Glühen ~ Die Glüht
Behavior – Das Verhalten ~ Die Verhaltensweisen
Passage – Der Durchgang ~ Die Durchgänge
Slave – Die Slave ~ Die Sklaven
Lieutenant – Der Leutnant ~ Die Leutnants
Barrel – Der Lauf ~ Die Fässer
Warmth – Die Wärme ~ Die Warmths
Impression – Der Eindruck ~ Die Eindrücke
Mason – Der Maurer ~ Die Maurer
Bride – Die Braut ~ Die Bräute
Package – Das Paket ~ Die Pakete
Fog – Der Nebel ~ Die Nebel
Walking – Das Gehen ~ Die Wanderungen
Balance – Die Balance ~ Die Salden
Sock – Die Socke ~ Die Socken
Robot – Der Roboter ~ Die Roboter
Potato – Die Kartoffel ~ Die Kartoffeln
Item – Der Gegenstand ~ Die Gegenstände
Bath – Das Bad ~ Die Bäder
Diamond – Der Diamant ~ Die Diamanten
Corpse – Die Leiche ~ Die Leichen
Explanation – Die Erklärung ~ Die Erläuterungen
Structure – Die Struktur ~ Die Strukturen
Exit – Der Ausgang ~ Die Ausgänge
Pad – Das Pad ~ Die Pads
Stove – Der Herd ~ Die Öfen
Blue – Das Blaue ~ Der Blues
American – Die Amerikaner ~ Die Amerikaner
Ruby – Der Rubin ~ Die Rubinen
Lightning – Der Blitz ~ Blitze
Pit – Die Grube ~ Die Gruben
Colonel – Der Oberst ~ Die Obersten
Dock – Das Dock ~ Die Docks
Creek – Der Bach ~ Die Bäche
Advice – Der Ratschlag ~ Die Ratschläge
Tourist – Der Tourist ~ Die Touristen
Grief – Die Trauer ~ Die Schmerzen
Defense – Die Verteidigung ~ Die Abwehrkräfte
Bite – Der Biss ~ Die Bisse
Museum – Das Museum ~ Die Museen
Favor – Die Gunst ~ Wohltaten
Supper – Das Abendessen ~ Die Abendessen
Comfort – Der Komfort ~ Komfort
Dean – Der Dekan ~ Die Dekane
Value – Der Wert ~ Die Werte
March – Der Marsch ~ Die Märsche
Estate – Das Anwesen ~ Die Stände
Poet – Der Poet ~ Die Dichter
Palace – Der Palast ~ Die Paläste
Soup – Die Suppe ~ Die Suppen
Nation – Die Nation ~ Die Nationen
Jar – Das Gefäss ~ Die Gläser
Standing – Der Ständige ~ Die Tabellenführung
Sack – Der Sack ~ Die Säcke
Demon – Der Dämon ~ Die Dämonen
Conference – Die Konferenz ~ Die Konferenzen
Juice – Der Saft ~ Die Säfte
Responsibility – Die Verantwortung ~ Die Zuständigkeiten
Brush – Der Pinsel ~ Die Bürsten
Route – Die Route ~ Die Strecken
Cheese – Der Käse ~ Die Käse
Hood – Die Haube ~ Die Hauben
Duck – Die Ente ~ Die Ente
Saint – Der Heilige ~ Die Heiligen
Pass – Der Pass ~ Die Pässe
Target – Das Ziel ~ Die Ziele
Orange – Die Orange ~ Die Orangen
Culture – Die Kultur ~ Die Kulturen
Tour – Die Reise ~ Die Touren
Commander – Der Kommandant ~ Die Kommandeure
Hook – Der Haken ~ Die Haken
Mist – Der Nebel ~ Die Nebel
Training – Das Training ~ Die Trainings
Search – Die Suche ~ Die Suche
Coin – Die Münze ~ Die Münzen
Miracle – Das Wunder ~ Die Wunder
Advantage – Der Vorteil ~ Die Vorteile
Exchange – Der Austausch ~ Die Börsen
Fiction – Die Fiktion ~ Fiktionen
Pond – Der Teich ~ Die Teiche
Assistant – Der Assistent ~ Die Assistenten
Design – Das Design ~ Die Entwürfe
Fishing – Die Angel ~ Die Fishings
Slope – Die Piste ~ Die Pisten
Earl – Der Graf ~ Die Grafen
Comment – Kommentar ~ Kommentare
Waiter – Der Kellner ~ Die Kellner
Grocery – Von Lebensmittel ~ Die Lebensmittel
Ladder – Die Leiter ~ Die Leitern
Curve – Die Kurve ~ Die Kurven
Volume – Das Volumen ~ Die Volumina
Risk – Das Risiko ~ Die Risiken
Nightmare – Der Albtraum ~ Die Alpträume
Existence – Die Existenz ~ Die Existenzen
Trace – Die Spur ~ Die Spuren
Disease – Die Krankheit ~ Die Krankheiten
Support – Die Unterstützung ~ Die Stützen
Witness – Der Zeuge ~ Die Zeugen
Stock – Die Aktie ~ Die Bestände
Device – Das Gerät ~ Die Vorrichtungen
Landscape – Die Landschaft ~ Die Landschaften
Holiday – Der Urlaub ~ Die Feiertage
Ace – Das Ass ~ Die Asse
Piano – Das Klavier ~ Die Klaviere
Gut – Die Eingeweide ~ Die Eingeweide
Talent – Das Talent ~ Die Talente
Imagination – Die Phantasie ~ Die Vorstellungen
Black – Die Schwarze ~ Die Schwarzen
Reed – Der Reed ~ Das Schilf
Lid – Der Deckel ~ Die Deckel
Hint – Der Hinweis ~ Die Hinweise
Walker – Der Wanderer ~ Die Wanderer
Chill – Die Kälte ~ Schüttelfrost
Trial – Die Studie ~ Die Prüfungen
Interview – Das Interview ~ Die Interviews
Approach – Der Ansatz ~ Die Ansätze
Scar – Die Narbe ~ Die Narben
Fashion – Die Mode ~ Die Mode
Channel – Der Kanal ~ Die Kanäle
Footstep – Die Tritt ~ Die Schritte
Pickup – Der Aufnehmer ~ Die Pickups
Hawk – Der Habicht ~ Die Falken
Trailer – Der Anhänger ~ Die Anhänger
Statue – Die Statue ~ Die Statuen
Pill – Die Pille ~ Die Pillen
Bug – Der Käfer ~ Die Bugs
Bucket – Der Eimer ~ Die Eimer
Vacation – Den Urlaub ~ Die Urlaub
Species – Die Arten ~ Die Specieses
Column – Die Kolumne ~ Die Spalten
Damage – Der Schaden ~ Die Schäden
Instrument – Das Instrument ~ Die Instrumente
Port – Der Hafen ~ Die Ports
Layer – Die Schicht ~ Die Schichten
Strip – Der Streifen ~ Die Streifen
Garbage – Der Müll ~ Die Garbages
Rib – Die Rippe ~ Die Rippen
Notebook – Das Notebook ~ Die Notizbücher
Corn – Der Mais ~ Die Hühneraugen
Offer – Das Angebot ~ Die Angebote
Drawing – Die Zeichnung ~ Die Zeichnungen
Statement – Die Aussage ~ Die Aussagen
Intelligence – Die Intelligenz ~ Die Intelligenzen
Excuse – Die Entschuldigung ~ Die Ausreden
Landing – Die Landung ~ Die Landungen
Copyright – Der Urheberrechts ~ Die Urheberrechte
Rod – Die Stange ~ Die Stäbe
Fantasy – Die Fantasie ~ Die Phantasien
Curiosity – Die Neugier ~ Die Kuriositäten
Gown – Das Kleid ~ Die Kleider
Border – Die Grenze ~ Die Grenzen
Poetry – Die Poesie ~ Die Dichtungen
Firm – Die Firma ~ Die Firmen
Rise – Der Aufgang ~ Der Anstieg
Handful – Die Handvoll ~ Die Hände Voll
China – Die China ~ Die Chinas
French – Die Franzosen ~ Die Frenches
Mean – Die Durchschnitts ~ Die Mittel
Deer – Das Reh ~ Die Hirsche
Print – Die Druck ~ Die Drucke
Rail – Die Schiene ~ Die Schienen
Rate – Die Rate ~ Die Preise
Courage – Der Mut ~ Die Courages
Arrival – Die Ankunft ~ Die Ankünfte
Wish – Der Wunsch ~ Wünsche
Ridge – Der Grat ~ Die Grate
Idiot – Der Idiot ~ Die Idioten
Bull – Der Bulle ~ Die Bullen
Seed – Die Saat ~ Die Samen
Progress – Der Fortschritt ~ Die Fortschritte
Feel – Das Gefühl ~ Es Fühlt Sich An
Shorts – Die Shorts ~ Die Shortses
Citizen – Der Bürger ~ Die Bürger
Trash – Der Müll ~ Die Trashes
Log – Das Protokoll ~ Die Protokolle
Patience – Die Geduld ~ Die Patiencen
Bat – Die Fledermaus ~ Die Fledermäuse
Football – Der Fußball ~ Die Fußbälle
Routine – Die Routine ~ Die Routinen
Explosion – Die Explosion ~ Die Explosionen
Content – Der Inhalt ~ Die Inhalte
Scientist – Der Wissenschaftler ~ Die Wissenschaftler
Failure – Das Versagen ~ Die Ausfälle
Sin – Die Sünde ~ Die Sünden
Butt – Der Hintern ~ Die Füße
Confusion – Die Verwirrung ~ Die Verwirrungen
Understanding – Das Verständnis ~ Die Absprachen
Trade – Der Handel ~ Das Handwerk
Refrigerator – Der Kühlschrank ~ Die Kühlschränke
Mister – Der Herr ~ Die Misters
Flashlight – Die Taschenlampe ~ Die Taschenlampen
Net – Das Internet ~ Die Netze
Sailor – Der Seemann ~ Die Matrosen
Attitude – Die Attitüde ~ Die Haltungen
Guilt – Die Schuld ~ Die Schuldgefühle
Crying – Das Weinen ~ Die Geschrei
Sip – Die Sip ~ Sips
Travel – Die Reise ~ Die Reisen
Cookie – Der Keks ~ Die Kekse
Escape – Die Flucht ~ Die Fluchten
Instruction – Die Anleitung ~ Die Anleitungen
Fabric – Das Gewebe ~ Die Stoffe
Marble – Der Marmor ~ Die Murmeln
Glimpse – Der Blick ~ Die Einblicke
Dusk – Die Dämmerung ~ Die Dämmerungen
Cottage – Die Hütte ~ Die Ferienhäuser
Monkey – Der Affe ~ Die Affen
Makeup – Das Makeup ~ Die MakeUps
Doc – Die Doc ~ Die Docs
Blouse – Die Bluse ~ Die Blusen
Rhythm – Der Rhythmus ~ Die Rhythmen
Steam – Der Dampf ~ Die Dämpfe
Phrase – Der Satz ~ Die Phrasen
Nut – Die Mutter ~ Die Muttern
Pencil – Der Bleistift ~ Die Stifte
Cook – Der Koch ~ Die Köche
Flag – Die Flagge ~ Die Fahnen
Coach – Der Trainer ~ Die Trainer
Swing – Die Schaukel ~ Die Schaukeln
Speaker – Der Lautsprecher ~ Die Lautsprecher
Bolt – Der Bolzen ~ Die Bolzen
Fat – Das Fett ~ Die Fette
Rug – Der Teppich ~ Die Teppiche
Knock – Die Klopf ~ Die Schläge
Spell – Der Zauber ~ Die Zaubersprüche
Taxi – Das Taxi ~ Die Taxis
Round – Die Runde ~ Die Runden
Straw – Der Strohhalm ~ Die Halme
Hatch – Die Luke ~ Die Luken
Fork – Die Gabel ~ Die Gabeln
Evil – Das Böse ~ Die Übel
Maid – Das Dienstmädchen ~ Die Zimmermädchen
Relative – Die Relative ~ Die Verwandten
Witch – Die Hexe ~ Die Hexen
Courtyard – Der Hof ~ Die Höfe
Sensation – Die Sensation ~ Die Empfindungen
Bubble – Die Blase ~ Die Blasen
Reader – Der Leser ~ Die Leser
Curl – Die Locke ~ Die Locken
Pie – Der Kuchen ~ Die Torten
Jet – Der Strahl ~ Die Jets
Shift – Die Verschiebung ~ Die Verschiebungen
Union – Die Union ~ Die Gewerkschaften
Teenager – Der Teenager ~ Die Teenager
Plain – Die Ebene ~ Die Ebenen
Waitress – Die Kellnerin ~ Die Kellnerinnen
Reply – Die Antwort ~ Die Antworten
Rumor – Das Gerücht ~ Gerüchte
Gravity – Die Schwerkraft ~ Die Gewichte
Shelter – Die Zuflucht ~ Die Unterstände
Adventure – Das Abenteuer ~ Die Abenteuer
Lion – Der Löwe ~ Die Löwen
Spine – Die Wirbelsäule ~ Die Stacheln
Confidence – Das Vertrauen ~ Die Vertraulichkeiten
Depth – Die Tiefe ~ Die Tiefen
Reach – Die Reichweite ~ Die Reichweiten
Hammer – Der Hammer ~ Die Hämmer
Bible – Die Bibel ~ Die Bibeln
Contract – Der Vertrag ~ Die Verträge
Wallet – Der Geldbeutel ~ Die Brieftaschen
Jungle – Der Dschungel ~ Die Dschungel
Factory – Die Fabrik ~ Die Fabriken
Indian – Die Indische ~ Die Indianer
Balcony – Der Balkon ~ Die Balkone
Rice – Der Reis ~ Die Reis
Knot – Der Knoten ~ Die Knoten
Cord – Die Schnur ~ Die Schnüre
Colleague – Der Kollege ~ Die Kollegen
Intention – Die Absicht ~ Die Absichten
Stare – Die Stare ~ Die Blicke
Motel – Das Motel ~ Die Motels
Attorney – Der Anwalt ~ Die Anwälte
Darling – Der Liebling ~ Die Lieblinge
Discussion – Die Diskussion ~ Die Diskussionen
Atmosphere – Atmosphäre ~ Die Atmosphären
Performance – Die Leistung ~ Die Aufführungen
Tension – Die Spannung ~ Die Spannungen
Text – Der Text ~ Die Texte
Strand – Der Strang ~ Die Litzen
Noon – Die Mittags ~ Die Noons
Vein – Die Vene ~ Die Venen
Expert – Der Experte ~ Die Experten
Gang – Die Gruppe ~ Die Banden
Policeman – Der Polizist ~ Die Police
Cancer – Der Krebs ~ Die Krebs
Fox – Der Fuchs ~ Die Foxs
Divorce – Die Scheidung ~ Die Scheidungen
Pulse – Die Impuls ~ Die Pulse
Absence – Die Abwesenheit ~ Die Abwesenheiten
Violence – Die Gewalt ~ Die Gewalten
Humor – Der Humor ~ Die Körpersäfte
Stool – Der Stuhl ~ Die Stühle
Gravel – Der Kies ~ Die Kiese
Treasure – Der Schatz ~ Schätze
Butter – Die Butter ~ Die Butter
Switch – Der Schalter ~ Die Schalter
Cigar – Die Zigarre ~ Die Zigarren
Canvas – Die Leinwand ~ Die Leinwände
Happiness – Die Fröhlichkeit ~ Die Seligkeiten
Guide – Der Führer ~ Die Führungen
Pin – Der Stift ~ Die Stifte
Actor – Der Schauspieler ~ Die Akteure
Whole – Das Ganze ~ Die Ganzen
Arrangement – Die Vereinbarung ~ Die Vereinbarungen
Brown – Die Braune ~ Die Brauntöne
Host – Der Gastgeber ~ Die Gastgeber
Ribbon – Das Farbband ~ Die Bänder
Scarf – Der Schal ~ Die Schals
Scale – Die Skala ~ Die Waagen
Proof – Der Beweis ~ Die Beweise
Arrow – Der Pfeil ~ Die Pfeile
Temperature – Die Temperatur ~ Die Temperaturen
Technology – Die Technologie ~ Technologien
Permission – Die Erlaubnis ~ Die Berechtigungen
Location – Der Ort ~ Die Standorte
Claw – Die Klaue ~ Die Krallen
Cowboy – Der Cowboy ~ Die Cowboies
Agency – Die Agentur ~ Die Agenturen
Construction – Die Konstruktion ~ Die Konstruktionen
Hunting – Das Jagd ~ Die Jagden
Vegetable – Das Gemüse ~ Das Gemüse
Tin – Die Dose ~ Die Dosen
Helicopter – Der Hubschrauber ~ Die Hubschrauber
Trap – Die Falle ~ Die Fallen
Pat – Das Pat ~ Die Streicheleinheiten
Gap – Die Lücke ~ Die Lücken
Pet – Das Haustier ~ Die Haustiere
Education – Die Bildung ~ Die Ausbildungen
Shopping – Das Einkaufen ~ Die Einkäufe
Shed – Der Schuppen ~ Die Schuppen
Agreement – Die Vereinbarung ~ Vereinbarungen
Soil – Die Erde ~ Die Böden
Duke – Der Herzog ~ Die Herzöge
Shotgun – Die Schrotflinte ~ Die Schrotflinten
Notion – Die Vorstellung ~ Die Begriffe
Rear – Es Gibt ~ Die Hintern
Ceremony – Die Zeremonie ~ Die Zeremonien
Spoon – Der Löffel ~ Die Löffel
Tub – Die Wanne ~ Die Wannen
Clue – Der Schlüssel ~ Die Hinweise
Iris – Die Iris ~ Die Iris
Incident – Der Vorfall ~ Die Vorfälle
Crash – Der Absturz ~ Die Abstürze
Journal – Das Tagebuch ~ Die Zeitschriften
Access – Die Zugriffs ~ Die Zugriffe
Brass – Erz ~ Die Brasses
Mommy – Die Mama ~ Die Mamas
Sidebar – Die Seitenleiste ~ Die Seitenleisten
Sheep – Das Schaf ~ Die Schafe
Engineer – Der Ingenieur ~ Die Ingenieure
Hull – Der Rumpf ~ Die Rümpfe
Odor – Der Geruch ~ Die Gerüche
Appointment – Der Termin ~ Die Termine
Invitation – Die Einladung ~ Die Einladungen
Rag – Die Lappen ~ Die Lumpen
Good – Das Gute ~ Die Güter
Dude – Der Kumpel ~ Die Dudes
Treatment – Die Behandlung ~ Behandlungen
Wisdom – Die Weisheit ~ Die Weisheiten
Prize – Der Preis ~ Die Preise
Element – Das Element ~ Die Elemente
Giant – Der Gigant ~ Die Riesen
Napkin – Die Serviette ~ Die Servietten
Laundry – Die Wäsche ~ Die Wäschereien
Option – Die Option ~ Die Optionen
Rack – Das Regal ~ Die Zahnstangen
Request – Die Anforderung ~ Die Anfragen
Jail – Das Gefängnis ~ Die Gefängnisse
Grandpa – Der Opa ~ Die Großväter
Ranch – Die Ranch ~ Die Ranches
Dot – Der Punkt ~ Die Punkte
Script – Das Skript ~ Die Skripte
Mall – Die Einkaufshalle ~ Die Einkaufszentren
Ford – Der Ford ~ Die Furten
Exercise – Die Übung ~ Die Übungen
Widow – Die Witwe ~ Die Witwen
Crow – Die Krähe ~ Die Krähen
Thread – Der Faden ~ Die Fäden
Suicide – Die Selbstmord ~ Die Selbstmorde
Notice – Die Notiz ~ Die Bekanntmachungen
Sunset – Der Sonnenuntergang ~ Die Sonne Geht Unter
Gallery – Die Gallerie ~ Die Galerien
Vessel – Das Schiff ~ Die Gefäße
Thunder – Der Donner ~ Der Donner
Soap – Die Seife ~ Seifen
Whiskey – Der Whisky ~ Die Whiskys
Female – Das Weibchen ~ Die Weibchen
Mayor – Der Bürgermeister ~ Die Bürgermeister
Stroke – Der Hub ~ Die Striche
Click – Der Klick ~ Die Klicks
Reputation – Der Ruf ~ Der Ruf
Miller – Der Müller ~ Die Müller
Council – Der Rat ~ Die Räte
Schedule – Der Stundenplan ~ Der Spielplan
Cemetery – Der Friedhof ~ Die Friedhöfe
Struggle – Der Kampf ~ Die Kämpfe
Instinct – Der Instinkt ~ Die Instinkte
Calm – Die Ruhe ~ Die Beruhigt
Employee – Der Arbeitnehmer ~ Die Angestellten
Nest – Das Nest ~ Die Nester
Limit – Das Limit ~ Die Grenzwerte
German – Der Deutsche ~ Die Deutschen
Monk – Der Mönch ~ Die Mönche
Worm – Der Wurm ~ Die Würmer
Document – Das Dokument ~ Die Dokumente
Sadness – Die Traurigkeit ~ Die Traurigkeiten
Hut – Die Hütte ~ Die Hütten
Lifetime – Die Lebensdauer ~ Die Lebensdauern
Dancer – Die Tänzerin ~ Die Tänzer
Insurance – Die Versicherung ~ Die Versicherungen
Difficulty – Die Schwierigkeit ~ Die Schwierigkeiten
Mattress – Die Matratze ~ Die Matratzen
Male – Der Mann ~ Die Männchen
Clinic – Die Klinik ~ Die Kliniken
Ad – Die Ad ~ Die Anzeigen
Mug – Der Becher ~ Die Becher
Kit – Das Kit ~ Die Kits
Communication – Die Kommunikation ~ Die Kommunikations
Disaster – Das Unglück ~ Die Katastrophen
Tile – Die Fliese ~ Die Fliesen
Receiver – Der Empfänger ~ Die Empfänger
Roar – Das Gebrüll ~ Die Brüllt
Troop – Die Truppe ~ Die Truppen
Coffin – Der Sarg ~ Die Särge
Friendship – Die Freundschaft ~ Die Freundschaften
Investigation – Die Ermittlung ~ Die Untersuchungen
Sale – Der Verkauf ~ Die Verkäufe
Goal – Das Ziel ~ Die Ziele
Ambulance – Der Krankenwagen ~ Die Krankenwagen
Moonlight – Das Mondlicht ~ Die Mondlicht
Ward – The Ward ~ Die Schutzzauber
Trousers – Die Hosen ~ Die Trouserses
Wool – Die Wolle ~ Die Wolle
Mac – Die Mac ~ Die Macs
Minister – Der Minister ~ Die Minister
Entry – Der Eintritt ~ Die Einträge
Thief – Der Dieb ~ Die Diebe
Briefcase – Die Aktentasche ~ Die Aktentaschen
Pity – Das Mitleid ~ Die Bemitleidet
Fingertip – Die Finger ~ Die Fingerspitzen
Navy – Die Marine ~ Die Marinen
Insect – Das Insekt ~ Die Insekten
Velvet – The Velvet ~ Die Samt
Bee – Die Biene ~ Die Bienen
Cane – Der Stock ~ Die Stöcke
Gene – Das Gen ~ Die Gene
Salad – Der Salat ~ Die Salate
Windshield – Die Windschutzscheibe ~ Die Windschutzscheiben
Outfit – Das Outfit ~ Die Outfits
Shuttle – Der Shuttle ~ Die Shuttles
Shout – Der Schrei ~ Die Rufe
Fury – Die Wut ~ Die Furien
Challenge – Die Herausforderung ~ Die Herausforderungen
Satisfaction – Die Zufriedenheit ~ Die Zufriedenheiten
Motor – Der Motor ~ Die Motoren
Product – Das Produkt ~ Die Produkte
Weed – Das Unkraut ~ Das Unkraut
Stretch – Die Strecke ~ Die Strecken
Gym – Das Fitnesscenter ~ Die FitnessStudios
Capital – Das Kapital ~ Die Hauptstädte
Rim – Der Rand ~ Die Felgen
Paw – Die Pfote ~ Die Pfoten
Fort – Die Festung ~ Die Forts
Cost – Die Kosten ~ Die Kosten
Poster – Das Plakat ~ Die Poster
Vampire – Der Vampir ~ Die Vampire
Shaft – Die Welle ~ Die Wellen
Identity – Die Identität ~ Die Identitäten
Pavement – Der Bürgersteig ~ Die Bürgersteige
Asshole – Das Arschloch ~ Die Arschlöcher
Strap – Der Gurt ~ Die Gurte
Parlor – Das Wohnzimmer ~ Die Stuben
Harbor – Der Hafen ~ Die Häfen
Example – Das Beispiel ~ Beispiele
Web – Das Netz ~ Die Stege
Golf – Der Golf ~ Die Golfplätze
Crap – Den Mist ~ Scheißt
Delight – Die Freude ~ Die Freuden
Quilt – Die Decke ~ Diese Decken
Tax – Die Steuer ~ Die Taxs
Fold – Die Falte ~ Die Falten
Portrait – Das Porträt ~ Die Porträts
Tissue – Das Gewebe ~ Die Gewebe
Belief – Der Glaube ~ Die Überzeugungen
Costume – Das Kostüm ~ Die Kostüme
Measure – Das Maß ~ Maßnahmen
Carriage – Der Wagen ~ Die Wagen
Guitar – Die Gitarre ~ Die Gitarren
Knight – Der Ritter ~ Die Ritter
Rank – Der Rang ~ Die Reihen
Major – Der Bürgermeister ~ Die Majors
Fountain – Der Brunnen ~ Die Brunnen
Stall – Der Stall ~ Die Stände
Load – Die Ladung ~ Die Lasten
Spark – Der Funke ~ Die Funken
Waste – Der Müll ~ Die Abfälle
Champagne – Der Champagner ~ Die Champagner
District – Das Viertel ~ Die Bezirke
Protection – Der Schutz ~ Die Schutz
Judgment – Das Urteil ~ Die Urteile
Sympathy – Die Sympathie ~ Die Sympathien
Violet – Das Violett ~ Die Veilchen
Impact – Der Aufprall ~ Die Auswirkungen
Disappointment – Die Enttäuschung ~ Die Enttäuschungen
Drinking – Das Trink ~ Die Drinkings
Consciousness – Das Bewusstsein ~ Die Bewussts
Handkerchief – Das Taschentuch ~ Die Taschentücher
Dancing – Das Tanzen ~ Die Dancings
Perfume – Das Parfüm ~ Die Düfte
Network – Das Netzwerk ~ Die Netzwerke
Claim – Der Anspruch ~ Die Ansprüche
Nun – Die Nonne ~ Die Nonnen
Crown – Die Krone ~ Die Kronen
Railing – Das Geländer ~ Die Geländer
License – Die Lizenz ~ Die Lizenzen
Mercy – Die Barmherzigkeit ~ Die Barmherzigkeit
Balloon – Der Ballon ~ Die Ballons
Chaos – Das Chaos ~ Die Chaoses
Fever – Das Fieber ~ Die Fieber
Locker – Das Schließfach ~ Die Schließfächer
Session – Die Sitzung ~ Die Sitzungen
Burst – Die Burst ~ Die Bursts
Peak – Der Spitzer ~ Die Peaks
Drum – Die Trommel ~ Die Trommeln
Focus – Der Fokus ~ Die Schwerpunkte
Frog – Der Frosch ~ Die Frösche
Benefit – Der Vorteil ~ Die Vorteile
Remark – Die Bemerkung ~ Die Bemerkungen
Tide – Die Gezeiten ~ Die Gezeiten
Suspicion – Der Verdacht ~ Der Verdacht
Jeep – Der Jeep ~ Die Jeeps
Worry – Die Sorge ~ Die Sorgen
Literature – Die Literatur ~ Die Literaturen
Archer – Der Bogenschütze ~ Die Bogenschützen
Household – Der Haushalt ~ Die Haushalte
Powder – Das Pulver ~ Die Pulver
Shepherd – Der Hirte ~ Die Hirten
Lens – Die Linse ~ Die Linsen
Favorite – Der Favorit ~ Die Favoriten
Madame – Die Madame ~ Die Madames
Mansion – Die Villa ~ Die Herrenhäuser
Boom – Der Boom ~ Die Ausleger
Lace – Die Spitze ~ Die Schnürsenkel
Review – Die Überprüfung ~ Die Bewertungen
Reception – Die Rezeption ~ Die Empfänge
Scrap – Der Schrott ~ Die Fetzen
Bead – Der Wulst ~ Die Perlen
Glare – Die Blendung ~ Die Blicke
Flow – Die Strömung ~ Die Ströme
Cafe – Das Cafe ~ Die Cafés
Status – Der Status ~ Die Zustände
Pounding – Das Pochen ~ Die Poundings
Rocket – Die Rakete ~ Die Raketen
Canyon – Die Schlucht ~ Die Schluchten
Sorrow – Die Trauer ~ Die Leiden
Spider – Die Spinne ~ Die Spinnen
Blast – Die Explosion ~ Die Blasten
Personality – Die Persönlichkeit ~ Die Persönlichkeiten
Campus – Der Campus ~ Die Campus
Curse – Der Fluch ~ Die Flüche
Staircase – Das Treppenhaus ~ Die Treppenhäuser
Urge – Der Drang ~ Die Triebe
Frustration – Die Frustration ~ Die Frustrationen
Pump – Die Pumpe ~ Die Pumpen
Ease – Die Leichtigkeit ~ Die Kungen
Count – Die Zählung ~ Die Grafen
Solution – Die Lösung ~ Die Lösungen
Jewelry – Der Schmuck ~ Die Schmuck
Siren – Die Sirene ~ Die Sirenen
Hit – Der Schlag ~ Die Treffer
Tradition – Die Tradition ~ Die Traditionen
Curb – Das Leer ~ Die Bordsteine
Variety – Die Vielfalt ~ Die Sorten
Pirate – Der Pirat ~ Die Piraten
Description – Die Beschreibung ~ Beschreibungen
Dear – Der Liebe ~ Die Lieben
Anxiety – Die Angst ~ Die Ängste
Pitch – Die Tonhöhe ~ Die Stellplätze
Pizza – Die Pizza ~ Die Pizzas
Elephant – Der Elefant ~ Die Elefanten
Politics – Die Politik ~ Die Politicses
Tennis – Der Tennis ~ Die Tennises
Hunger – Der Hunger ~ Die Hungert
Genius – Das Genie ~ Die Genies
Goat – Die Ziege ~ Die Ziegen
Victory – Der Sieg ~ Die Siege
Combination – Die Kombination ~ Kombinationen
Affiliation – Die Zugehörigkeit ~ Die Zugehörigkeiten
Momma – Das Momma ~ Die Mommas
Cape – Der Umhang ~ Die Umhänge
Headlight – Der Scheinwerfer ~ Die Scheinwerfer
Governor – Der Gouverneur ~ Die Gouverneure
Oxygen – Die Sauerstoff ~ Sauerstoffe
Bishop – Der Bischof ~ Die Bischöfe
Bundle – Das Bündel ~ Die Bündel
Development – Die Entwicklung ~ Die Entwicklungen
Fingernail – Der Fingernagel ~ Die Fingernägel
Score – Die Punktzahl ~ Die Noten
Mate – Der Steuermann ~ Die Mates
Rider – Der Fahrer ~ Die Fahrer
Orbit – Die Umlaufbahn ~ Die Bahnen
Vine – Der Weinstock ~ Die Reben
Suite – Die Suite ~ Die Suiten
Bartender – Der Barkeeper ~ Die Barkeeper
Coke – Der Koks ~ Die Kokse
Tune – Die Melodie ~ Die Melodien
Glory – Die Herrlichkeit ~ Die Herrlichkeiten
Rabbi – Der Rabbi ~ Die Rabbiner
Surgery – Die Operation ~ Die Operationen
Cattle – Das Vieh ~ Die Rinder
Ritual – Das Ritual ~ Die Rituale
Greeting – Die Begrüßung ~ Die Grüße
Slice – Die Scheibe ~ Die Scheiben
Homer – Die Homer ~ Die Home Runs
Fireplace – Der Kamin ~ Die Kamine
Jersey – Das Trikot ~ Die Trikots
Media – Die Medien ~ Die Medien
Pop – Die Pop ~ The Pops
Cargo – Die Fracht ~ Die Ladungen
Inn – Das Gasthaus ~ Die Gasthöfe
Deputy – Der Stellvertretende ~ Die Abgeordneten
Despair – Die Verzweiflung ~ Die Verzweiflungen
Territory – Das Territorium ~ Die Gebiete
Punch – Der Schlag ~ Die Stempel
Jazz – Die Jazz ~ Die Jazzs
Hug – Die Umarmung ~ Die Umarmungen
Whistle – Die Pfeife ~ Die Pfeifen
Humanity – Die Menschlichkeit ~ Geisteswissenschaften
Craft – Das Handwerk ~ Das Handwerk
Daylight – Das Tageslicht ~ Die Daylighies
Worth – Der Wert ~ Die Inneren Werte
Slip – Der Slip ~ Die Schieber
Armor – Die Rüstung ~ Die Rüstungen
Backpack – Der Rucksack ~ Die Rucksäcke
Suggestion – Der Vorschlag ~ Die Vorschläge
Den – Die Höhle ~ Dens
Symbol – Das Symbol ~ Die Symbole
Colony – Die Kolonie ~ Die Kolonien
Conclusion – Das Fazit ~ Die Schlussfolgerungen
Nostril – Das Nasenloch ~ Die Nasenlöcher
Spear – Der Speer ~ Die Speere
Impulse – Der Impuls ~ Die Impulse
Tomato – Die Tomate ~ Die Tomaten
Calf – Das Kalb ~ Die Kälber
Autumn – Der Herbst ~ Die Herbste
Discovery – Der Fund ~ Die Entdeckungen
Classroom – Das Klassenzimmer ~ Die Klassenzimmer
Delivery – Die Lieferung ~ Die Einteilungen
Spray – Das Spray ~ Die Spraies
Liquid – Die Flüssigkeit ~ Die Flüssigkeiten
Fuel – Die Kraftstoff ~ Die Kraftstoffe
Underwear – Die Unterwäsche ~ Die Unterwäsche
Dome – Die Kuppel ~ Die Kuppeln
Population – Die Bevölkerung ~ Die Populationen
Affection – Die Neigung ~ Die Neigungen
Religion – Die Religion ~ Die Religionen
Singer – Der Sänger ~ Die Sänger
Attendant – Der Begleiter ~ Die Teilnehmer
Illusion – Die Illusion ~ Die Illusionen
Link – Der Link ~ Links
Lounge – Das Wohnzimmer ~ Die Lounges
Interior – Der Innenraum ~ Die Innenräume
Shrug – Die Achselzucken ~ Die Zuckt Mit Den Schultern
Zone – Die Zone ~ Die Zonen
Standard – Der Standard ~ Die Standards
Coal – Die Kohlen ~ Die Kohlen
Chase – Die Jagd ~ Die Verfolgungsjagden
Lump – Der Klumpen ~ Die Klumpen
Charm – Der Charm ~ Der Charme
Legend – Die Legende ~ Die Legenden
Consequence – Die Konsequenz ~ Die Konsequenzen
Observation – Die Beobachtung ~ Die Beobachtungen
Bicycle – Das Fahrrad ~ Die Fahrräder
Harm – Der Schaden ~ Die Schäden
Pay – Die Zahlung ~ Das Zahlt
Prospect – Das Prospekt ~ Die Aussichten
Subway – Die UBahn ~ Die UBahnen
Sample – Das Muster ~ Die Beispiele
Cherry – Die Kirsche ~ Die Kirschen
Dealer – Der Händler ~ Die Händler
Assignment – Die Zuordnung ~ Die Zuordnungen
Hurry – Die Eile ~ Die Eilt
Mistress – Die Geliebte ~ Die Mätressen
Mound – Der Hügel ~ Die Hügel
Nonsense – Der Unsinn ~ Die Unsinn
Committee – Das Komitee ~ Die Ausschüsse
Echo – Das Echo ~ Die Echos
Slack – Der Durchhang ~ Die Hose
Decker – Die Decker ~ Die Decker
Warehouse – Das Warenhaus ~ Die Lagerhäuser
Bout – Der Kampf ~ Die Kämpfe
Toast – Der Toast ~ Die Toasts
Facility – Die Einrichtung ~ Die Einrichtungen
Basketball – Der Basketball ~ Die Basketbälle
Mustache – Der Schnurrbart ~ Die Schnurrbärte
Senator – Der Senator ~ Die Senatoren
Share – Das Teilen ~ Die Aktien
Eyelid – Das Augenlid ~ Die Augenlider
Enthusiasm – Die Begeisterung ~ Die Begeisterung
Chunk – Die Chunk ~ Die Brocken
Turtle – Die Schildkröte ~ Die Schildkröten
Alcohol – Der Alkohol ~ Die Alkohole
Gum – Die Gummi ~ Die Gummis
Turkey – Der Truthahn ~ Die Truthähne
Preacher – Der Prediger ~ Die Prediger
Possession – Der Besitz ~ Die Besitzungen
Dolly – Der Dolly ~ Die Dollies
Linen – Das Leinen ~ Die Bettwäsche
Apology – Die Entschuldigung ~ Die Entschuldigung
Lecture – Der Vortrag ~ Die Vorträge
Boulder – Der Stein ~ Die Felsbrocken
Heap – Der Heap ~ Die Haufen
Photographer – Der Fotograf ~ Die Fotografen
Brake – Die Bremse ~ Die Bremsen
Demand – Die Nachfrage ~ Die Forderungen
Apron – Die Schürze ~ Die Schürzen
Cloak – Der Mantel ~ Die Umhänge
Jury – Die Jury ~ Jurys
Hearing – Die Anhörung ~ Die Anhörungen
Gray – Das Graue ~ Die Grautöne
Crate – Die Kiste ~ Die Kisten
Method – Die Methode ~ Methoden
Reference – Die Referenz ~ Die Verweise
Disgust – Der Ekel ~ Die Ekelt
Liquor – Die Flotte ~ Die Flotten
Lipstick – Der Lippenstift ~ Lippenstifte
Core – Der Kern ~ Die Kerne
Individual – Der Einzelne ~ Die Personen
Container – Der Container ~ Die Behälter
Whore – Die Hure ~ Die Huren
Infant – Das Kleinkind ~ Die Säuglinge
Sunglasses – Die Sonnenbrille ~ Die Sunglasseses
Hose – Der Schlauch ~ Die Schläuche
Concert – Das Konzert ~ Konzerte
Bullshit – Das Bullshit ~ Die Bullshits
Railroad – Die Eisenbahn ~ Die Eisenbahnen
Parade – Die Parade ~ Die Paraden
Compartment – Das Fach ~ Die Abteile
Resident – Der Bewohner ~ Die Bewohner
Oven – Der Backofen ~ Die Öfen
Technician – Der Techniker ~ Die Techniker
Procedure – Das Verfahren ~ Die Verfahren
Fighter – Der Kämpfer ~ Die Kämpfer
Grain – Das Korn ~ Die Körner
Picnic – Das Picknick ~ Die Picknicks
Tribe – Der Stamm ~ Die Stämme
Bud – Die Knospe ~ Die Knospen
Meadow – Die Wiese ~ Die Wiesen
Public – Die Öffentlichkeit ~ Die Öffentlichkeit
Poison – Das Gift ~ Die Gifte
Buffalo – Der Büffel ~ Die Büffel
Region – Die Region ~ Die Regionen
Production – Die Produktion ~ Die Produktionen
Running – Das Rennen ~ Die Vorlauf
Loop – Die Schleife ~ Die Schlaufen
Sleeping – Der Schlaf ~ Die Übernachtungsplätzen
Soda – Die Soda ~ Die Limonaden
Owl – Die Eule ~ Die Eulen
Menu – Das Menü ~ Die Menüs
Kick – Der Kick ~ Die Tritte
Ruin – Die Ruine ~ Die Ruinen
Ramp – Die Rampe ~ Die Rampen
Streak – Der Streifen ~ Die Streifen
Forearm – Unterarm ~ Die Unterarme
Bureau – Das Büro ~ Die Büros
Knuckle – Der Achsschenkel ~ Die Knöchel
Goose – Die Gans ~ Die Gänse
Advance – Der Vormarsch ~ Die Fortschritte
Fairy – Die Fee ~ Die Feen
Illness – Die Krankheit ~ Die Krankheiten
Squad – Die Mannschaft ~ Die Kader
Official – Das Offizielle ~ Die Beamten
Brand – Die Marke ~ Die Marken
Organ – Die Orgel ~ Die Organe
Butterfly – Der Schmetterling ~ Die Schmetterlinge
Empire – Das Reich ~ Die Reiche
Profile – Das Profil ~ Die Profile
Liberty – Die Freiheit ~ Freiheiten
Disbelief – Der Unglaube ~ Die Unglauben
Grove – Der Hain ~ Die Haine
Shield – Das Schild ~ Die Abschirmungen
Saddle – Der Sattel ~ Die Sättel
Odds – Die Chancen ~ Die Oddses
Cluster – Die Cluster ~ Die Cluster
Satellite – Der Satellit ~ Die Satelliten
Trigger – Der Abzug ~ Die Auslöser
Puppy – Der Welpe ~ Die Welpen
Waiting – Die Warte ~ Die Erwartungen
Bulb – Die Glühbirne ~ Die Zwiebeln
Dresser – Die Kommode ~ Die Kommoden
Patrol – Die Patrouille ~ Die Patrouillen
Eagle – Der Adler ~ Die Adler
Privacy – Der Privatsphäre ~ Die Privatsphären
Fluid – Das Fluid ~ Fluide
Herd – Die Herde ~ Die Herden
Headache – Der Kopfschmerz ~ Die Kopfschmerzen
Amusement – Der Vergnügungspark ~ Vergnügungen
Wheelchair – Der Rollstuhl ~ Die Rollstühle
Policy – Die Richtlinie ~ Die Politik
Belle – Das Belle ~ Die Belles
Tobacco – Die Tabak ~ Die Tabake
Setting – Die Einstellung ~ Einstellungen
Tattoo – Die Tätowierung ~ Die Tattoos
Burden – Die Last ~ Die Lasten
Merchant – Der Händler ~ Die Kaufleute
Slide – Die Rutsche ~ Die Schieber
Stain – Der Fleck ~ Die Flecken
Eating – Das Essen ~ Die Eatings
Bond – Die Bindung ~ Die Anleihen
Swimming – Das Schwimmen ~ Die Swimming
Foundation – Die Grundlage ~ Die Grundlagen
Injury – Die Verletzung ~ Die Verletzungen Haben
League – Die Liga ~ Die Ligen
Battery – Die Batterie ~ Die Batterien
Umbrella – Der Regenschirm ~ Die Sonnenschirme
Emperor – Der Kaiser ~ Die Kaiser
Pier – Der Pier ~ Die Pfeiler
Tap – Der Wasserhahn ~ Die Wasserhähne
Wit – Der Witz ~ Die Verstand
Cutter – Der Cutter ~ Die Schneidwerkzeuge
Attic – Der Dachboden ~ Die Dachböden
Tiger – Der Tiger ~ Die Tiger
Pal – Die Pal ~ Die Kumpels
Ancestor – Der Vorfahr ~ Die Vorfahren
Concentration – Die Konzentration ~ Die Konzentrationen
Mount – Der Berg ~ Die Halterungen
Expense – Der Aufwand ~ Die Kosten
Blessing – Der Segen ~ Die Segnungen
Leave – Der Urlaub ~ Das Laub
Ledge – Die Leiste ~ Die Leisten
Torch – Die Fackel ~ Die Fackeln
Ink – Die Tinten ~ Die Tinten
Plot – Die Handlung ~ Die Grundstücke
Rent – Die Miete ~ Die Mieten
Mule – Das Maultier ~ Die Maultiere
Arch – Der Bogen ~ Die Bögen
Environment – Die Umgebung ~ Die Umgebungen
Frown – Das Stirnrunzeln ~ Die Stirn Runzelt
Inspector – Der Inspektor ~ Die Inspektoren
Midst – Die Mitten ~ Die Midsts
Embarrassment – Die Verlegenheit ~ Die Peinlichkeiten
Complaint – Die Beschwerde ~ Die Beschwerden
Portion – Die Portion ~ Die Portionen
Chuck – Das Spannfutter ~ Die Spann
Clearing – Die Clearing ~ Die Lichtungen
Crisis – Die Krise ~ Die Krisen
Necklace – Die Halskette ~ Die Halsketten
Lantern – Die Laterne ~ Die Laternen
Wealth – Der Reichtum ~ Die Reichtümer
Murderer – Der Mörder ~ Die Mörder
Civilization – Die Zivilisation ~ Die Zivilisationen
Concept – Das Konzept ~ Die Konzepte
Lamb – Das Lamm ~ Die Lämmer
Stride – Die Schritt ~ Die Fortschritte
Cuff – Die Manschette ~ Die Manschetten
Virgin – Die Jungfrau ~ Die Jungfrauen
Squirrel – Das Eichhörnchen ~ Die Eichhörnchen
Babe – Das Kind ~ Die Babes
Starling – Der Star ~ Die Stare
Depression – Die Depression ~ Die Vertiefungen
Storage – Das Speicher ~ Die Speicher
Altar – Der Altar ~ Die Altäre
Tragedy – Die Tragödie ~ Die Tragödien
Resource – Die Ressource ~ Die Mittel
Traveler – Der Reisende ~ Die Reisenden
Trust – Das Vertrauen ~ Die Trusts
Arc – Die Bogen ~ Die Bögen
Kingdom – Das Königreich ~ Die Königreiche
Jewel – Das Juwel ~ Die Juwelen
Musician – Der Musiker ~ Die Musiker
Airplane – Das Flugzeug ~ Die Flugzeuge
Junk – Die Junk ~ Die Dschunken
Sunshine – Der Sonnenschein ~ Die Sonne Scheint
Lad – Der Knabe ~ Die Jungs
Elf – Der Elf ~ Die Elfen
Protest – Der Protest ~ Die Proteste
Hunt – Die Jagd ~ Die Jagden
Executive – Die Exekutive ~ Die Führungskräfte
Diary – Das Tagebuch ~ Die Tagebücher
Aspect – Das Aspekt ~ Die Aspekte
Dial – Das Zifferblatt ~ Die Zifferblätter
Slipper – Der Hausschuh ~ Die Pantoffeln
Actress – Die Schauspielerin ~ Die Schauspielerinnen
Shooting – Das Shooting ~ Die Dreharbeiten
Earring – Der Ohrring ~ Die Ohrringe
Ant – Die Ameise ~ Die Ameisen
Patty – Die Patty ~ Die Bratlinge
Sauce – Die Sauce ~ Die Soßen
Missile – Die Rakete ~ Die Raketen
Intensity – Die Intensität ~ Die Intensitäten
Ditch – Der Graben ~ Die Gräben
Daisy – Das Gänseblümchen ~ Das Gänseblümchen
Chapel – Die Kapelle ~ Die Kapellen
Swamp – Der Sumpf ~ Die Sümpfe
Relation – Die Beziehung ~ Die Beziehungen
Guess – Die Vermutung ~ Die Vermutungen
Crane – Der Kran ~ Die Kräne
Encounter – Die Begegnung ~ Die Begegnungen
Sequence – Die Sequenz ~ Die Sequenzen
Fragment – Das Fragment ~ Die Fragmente
Draft – Der Entwurf ~ Die Entwürfe
Diner – Das Diner ~ Diners
Function – Die Funktion ~ Die Funktionen
Organization – Die Organisation ~ Die Organisationen
Skeleton – Das Skelett ~ Die Skelette
Misery – Das Elend ~ Das Elend
Herb – Das Kraut ~ Die Kräuter
Stump – Der Stumpf ~ Die Stümpfe
Stake – Der Einsatz ~ Die Einsätze
Puff – Die Puff ~ Die Windbeutel
Creation – Die Kreation ~ Die Kreationen
Wake – Das Gefolge ~ Die Totenwache
Wizard – Der Zauberer ~ Die Zauberer
Mat – Die Matte ~ Die Matten
Seal – Die Dichtung ~ Die Dichtungen
Twilight – Das Zwielicht ~ Die Dämmerungen
Grunt – Das Grunzen ~ Das Grunzen
Punishment – Die Strafe ~ Die Strafen
Clan – Der Clan ~ Die Clans
Copper – Das Kupfer ~ Die Kupfer
Debris – Die Trümmer ~ Die Debrises
Painter – Der Maler ~ Die Maler
Steering – Das Steuer ~ Die Lenkungen
Math – Die Mathematik ~ Die Mathematik
Recognition – Die Erkennung ~ Die Anerkennungen
Temper – Die Stimmung ~ Die Gemüter
Regret – Das Bedauern ~ Die Reue
Destination – Das Ziel ~ Die Ziele
Mill – Die Mühle ~ Die Mühlen
Error – Der Fehler ~ Die Fehler
Romance – Die Romantik ~ Die Romane
Topic – Das Thema ~ Die Themen
Patio – Die Terrasse ~ Die Innenhöfe
Shovel – Die Schaufel ~ Schaufeln
Pajamas – Die Schlafanzüge ~ Die Pajamases
EMail – Die Email ~ Die EMails
Pigeon – Die Taube ~ Die Tauben
Dinosaur – Der Dinosaurier ~ Die Dinosaurier
Industry – Die Branche ~ Die Industrie
Operator – Der Betreiber ~ Die Betreiber
Lift – Der Lift ~ Die Lifte
Counselor – Der Ratgeber ~ Die Berater
Gathering – Die Versammlung ~ Die Versammlungen
Principle – Das Prinzip ~ Die Grundsätze
Drama – Das Drama ~ Die Dramen
Chick – Das Küken ~ Die Küken
Chart – Das Diagramm ~ Die Charts
Campaign – Die Kampagne ~ Die Kampagnen
Laurel – Der Lorbeer ~ Die Lorbeeren
Steak – Das Steak ~ Die Steaks
Criminal – Der Kriminelle ~ Die Verbrecher
Globe – Der Globus ~ Die Kugeln
Bruise – Der Bluterguss ~ Die Blauen Flecken
Knob – Der Knopf ~ Die Noppen
Killing – Das Töten ~ Die Morde
Sweetheart – Der Schatz ~ Die Lieblinge
Opera – Die Oper ~ Die Opern
Frost – Der Frost ~ Die Fröste
Nipple – Der Nippel ~ Die Brustwarzen
Reverend – Der Pfarrer ~ Die Pastoren
Haze – Die Trübung ~ Die Trübungen
Flood – Das Hochwasser ~ Die Fluten
Carol – Das Weihnachtslied ~ Die Weihnachtslieder
Weakness – Die Schwäche ~ Schwächen
Cooking – Das Kochen ~ Die Cookings
Butcher – Der Metzger ~ Die Metzger
Cube – Der Würfel ~ Die Würfel
Cellar – Der Keller ~ Die Keller
Hollow – Der Hohl ~ Die Hohlräume
Bump – Der Höcker ~ Die Höcker
Halt – Der Halt ~ Die Haltepunkte
Hay – Das Heu ~ Hays
Bark – Die Rinde ~ Die Rinden
Survival – Die Überlebens ~ Die Überreste
Bunk – Die Etagen ~ Die Kojen
Bend – Die Biegung ~ Die Biegungen
Approval – Die Freigabe ~ Die Zulassungen
Division – Der Unternehmensbereich ~ Die Abteilungen
Cocktail – Der Cocktail ~ Die Cocktails
Contest – Der Wettbewerb ~ Die Neuesten Informationen
Paradise – Das Paradies ~ Die Paradiese
Razor – Das Rasiermesser ~ Die Rasierer
Catch – Der Fang ~ Die Fänge
Blossom – Die Blüte ~ Die Blüten
Puddle – Die Pfütze ~ Die Pfützen
Electricity – Der Strom ~ Die Elektricitäten
Onion – Die Zwiebel ~ Die Zwiebeln
Laser – Die Laser ~ Die Laser
Cushion – Das Kissen ~ Die Kissen
Influence – Der Einfluss ~ Die Einflüsse
Jump – Der Sprung ~ Die Sprünge
Cement – Der Zement ~ Die Zemente
Amber – Die Gelbe ~ The Ambers
Goddess – Die Göttin ~ Die Göttinnen
Shack – The Shack ~ Die Baracken
Sales – Die Verkäufe ~ Die Saleses
Drift – Die Drift ~ Die Drifts
Fighting – Die Kämpfe ~ Die Kämpfe
Braid – Das Geflecht ~ Die Zöpfe
Theme – Das Thema ~ Die Themen
Dignity – Die Würde ~ Die Dignität
Lemon – Die Zitrone ~ Die Zitronen
Clown – Der Clown ~ Die Clowns
Assault – Der Angriff ~ Die Angriffe
Goggle – Die Brille ~ Die Schutzbrillen
Destruction – Die Zerstörung ~ Die Zerstörungen
Exception – Die Ausnahme ~ Die Ausnahmen
Peach – Der Pfirsich ~ Die Pfirsiche
Wash – Die Wasch ~ Die Wasch
Release – Die Befreiung ~ Die Freigaben
Spy – Der Spion ~ Die Spione
Tag – Die Tag ~ Die Tags
Bra – Der Bh ~ Die Bhs
Debt – Die Schuld ~ Die Schulden
Terrace – Die Terrasse ~ Die Terrassen
Remains – Die Überbleibsel ~ Die Remainses
Logic – Die Logik ~ Die Logik
Joint – Der Joint ~ Die Gelenke
Pitcher – Der Krug ~ Die Krüge
Perspective – Die Perspektive ~ Die Perspektiven
Crop – Die Ernte ~ Die Ernte
Graduate – Der Diplom ~ Die Absolventen
Chorus – Der Chor ~ Die Chöre
Survivor – Der Überlebende ~ Die Überlebenden
Payment – Die Bezahlung ~ Zahlungen
Bet – Die Wette ~ Die Wetten
Revenge – Die Rache ~ Die Rache
Plaza – Der Platz ~ Die Plätze
Elder – Der Ältere ~ Die Ältesten
Ginger – Der Ingwer ~ Die Ingwer
Surgeon – Der Chirurg ~ Die Chirurgen
Dash – Der Bindestrich ~ Die Striche
Sandal – Die Sandale ~ Die Sandalen
Hatred – Der Hass ~ Die Hass
Departure – Die Abfahrt ~ Die Abfahrten
Outline – Der Umriss ~ Die Umrisse
Raven – Der Rabe ~ Die Raben
Runner – Der Läufer ~ Die Läufer
Anticipation – Die Vorfreude ~ Die Erwartungen
Translation – Die Übersetzung ~ Die Übersetzungen
Headquarters – Das Hauptquartier ~ Die Headquarterses
Celebration – Feier ~ Die Feiern
Agony – Die Qual ~ Die Qualen
Sneakers – Die Turnschuhe ~ Die Sneakerses
Terminal – Das Terminal ~ Die Endgeräte
Expectation – Die Erwartung ~ Die Erwartungen
Pasture – Die Weide ~ Die Weiden
Console – Die Konsole ~ Die Konsolen
Strike – Der Streik ~ Die Streiks
Rescue – Die Rettung ~ Die Rettungsaktionen
Badge – Das Abzeichen ~ Badges
Fund – Der Fonds ~ Die Mittel
Try – Der Versuch ~ Die Versuche
Foyer – Das Foyer ~ Die Foyeies
Pastor – Der Pastor ~ Die Pastoren
Embrace – Die Umarmung ~ Die Umarmungen
Puzzle – Das Puzzle ~ Die Rätsel
Canal – Der Kanal ~ Die Kanäle
Charity – Die Wohlfahrt ~ Die Wohltätigkeitsorganisationen
Principal – Der Direktor ~ Die Auftraggeber
Applause – Der Applaus ~ Die Beifall
Philosophy – Die Philosophie ~ Die Philosophien
Trench – Der Graben ~ Die Gräben
Up – Die Bis ~ Die Höhen
Nephew – Der Neffe ~ Die Neffen
Essay – Der Aufsatz ~ Die Aufsätze
Repair – Die Reparatur ~ Die Reparaturen
Mix – Der Mix ~ Die Mixs
Mob – Der Mob ~ Die Mobs
Barrier – Die Barriere ~ Die Barrieren
Disk – Die Platte ~ Die Scheiben
Goodness – Die Güte ~ Die Goodnesses
Scout – Der Scout ~ Die Pfadfinder
Importance – Die Wichtigkeit ~ Die Wichtigkeiten
Destiny – Das Schicksal ~ Die Schicksale
Aid – Die Beihilfen ~ Die Beihilfen
Microphone – Das Mikrofon ~ Die Mikrofone
Label – Das Etikett ~ Die Etiketten
Pepper – Der Pfeffer ~ Die Paprika
Coyote – Der Kojote ~ Die Kojoten
Teaching – Das Lehren ~ Die Lehren
Burn – Der Brennvorgang ~ Die Verbrennungen
Vest – Die Weste ~ Die Westen
Pony – Das Pony ~ Die Ponys
Donkey – Der Esel ~ Die Esel
Cycle – Der Kreislauf ~ Die Zyklen
Gasp – Das Keuchen ~ Die Keuchen
Irony – Die Ironie ~ Die Ironien
Award – Die Auszeichnung ~ Die Auszeichnungen
Grape – Die Traube ~ Die Trauben
Hesitation – Das Zögern ~ Die Bedenken
Tavern – Die Taverne ~ Die Tavernen
Chore – Die Lästige Pflicht ~ Die Hausarbeiten
Sphere – Die Kugel ~ Die Kugeln
Sail – Das Segel ~ Die Segel
Silhouette – Die Silhouette ~ Die Silhouetten
Institute – Das Institut ~ Die Institute
Liar – Der Lügner ~ Die Lügner
Technique – Die Technik ~ Die Techniken
Index – Der Index ~ Die Indexs
Plank – Das Brett ~ Die Bretter
Jerk – Der Ruck ~ Die Idioten
Growth – Das Wachstum ~ Die Wucherungen
Stocking – Der Strumpf ~ Die Strümpfe
Blackness – Die Schwärze ~ Die Schwärzen
Teen – Der Teenager ~ Die Jugendlichen
Bracelet – Das Armband ~ Die Armbänder
Jelly – Das Gelee ~ Die Gelees
Diet – Die Diät ~ Die Diäten
Beef – Das Fleisch ~ Die Beefs
Concrete – Der Beton ~ Die Betone
Contrast – Der Kontrast ~ Die Gegensätze
Banner – Das Banner ~ Die Banner
Resistance – Der Widerstand ~ Die Widerstände
Stay – Der Aufenthalt ~ Die Aufenthalte
Posture – Die Haltung ~ Die Haltungen
Vodka – Der Wodka ~ Die Wodkas
Album – Das Album ~ Die Alben
Era – Die Ära ~ Die Epochen
Acquaintance – Die Bekanntschaft ~ Die Bekannten
Revolution – Die Revolution ~ Die Revolutionen
Nap – Der Nap ~ Die Noppen
Veil – Der Schleier ~ Die Schleier
Spectacle – Das Schauspiel ~ Die Brille
Competition – Der Wettbewerb ~ Die Wettbewerbe
Scalp – Die Kopfhaut ~ Die Kopfhaut
Holly – Die Stechpalme ~ The Hollies
Winner – Der Gewinner ~ Die Gewinner
Appetite – Der Appetit ~ Die Appetit
Ivy – Der Efeu ~ Die Efeu
Cue – Der Cue ~ Die Stichworte
Strain – Der Stamm ~ Die Stämme
Niece – Die Nichte ~ Die Nichten
Galaxy – Die Galaxie ~ Die Galaxien
Bedside – Die Nacht ~ Die Bettseiten
Madness – Die Verrücktheit ~ Die Verrücktheiten
Baker – Der Bäcker ~ Die Bäcker
Virus – Das Virus ~ Die Viren
Suffering – Das Leiden ~ Die Leiden
Slot – Der Schlitz ~ Die Schlitze
Folder – Der Ordner ~ Die Hefte
Confession – Das Bekenntnis ~ Die Geständnisse
Porter – Der Gepäckträger ~ Die Torhüter
Dessert – Das Dessert ~ Die Desserts
Dump – Die Müllhalde ~ Die Deponien
Packet – Das Paket ~ Die Pakete
Profit – Der Gewinn ~ Die Gewinne
Grandchild – Der Enkel ~ Die Enkelkinder
Gossip – Der Tratsch ~ Der Klatsch
Mare – Die Stute ~ Die Stuten
Dna – Die Dna ~ Die Dnas
Torso – Der Rumpf ~ Die Torsi
Broom – Der Besen ~ Die Besen
Hoof – Der Huf ~ Die Hufe
Sensor – Der Sensor ~ Die Sensoren
Peasant – Der Bauer ~ Die Bauern
Scholar – Der Gelehrte ~ Die Gelehrten
Therapy – Die Therapie ~ Die Therapie
Peanut – Die Erdnuss ~ Die Erdnüsse
Headline – Die Schlagzeile ~ Schlagzeilen
Bacon – Der Speck ~ Die Speck
Stern – Das Heck ~ Die Hecks
Violin – Die Geige ~ Die Violinen
Plague – Die Pest ~ Die Plagen
Blur – Die Unschärfe ~ Die Unschärfen
Meantime – Die Zwischenzeit ~ Die Zwischenzeiten
Deacon – Der Diakon ~ Die Diakone
Lance – Die Lanze ~ Die Lanzen
Arrest – Die Festnahme ~ Die Verhaftungen
Banana – Die Banane ~ Die Bananen
Gin – Der Gin ~ Die Gins
Willow – Die Weide ~ Die Weiden
Shark – Der Hai ~ Die Haie
Preparation – Die Vorbereitung ~ Die Vorbereitungen
Scratch – Die Kratz ~ Die Kratzer
Dressing – Der Verband ~ Die Verbände
Signature – Die Unterschrift ~ Unterschriften
Admiral – Der Admiral ~ Die Admirale
Analysis – Die Analyse ~ Die Analysisies
Rainbow – Der Regenbogen ~ Die Regenbogen
Lizard – Die Eidechse ~ Die Eidechsen
Dwarf – Der Zwerg ~ Die Zwerge
Stress – Der Stress ~ Die Belastungen
Homework – Die Hausaufgabe ~ Die Hausaufgaben
Mixture – Die Mischung ~ Die Mischungen
Verse – Der Vers ~ Die Verse
Conviction – Die Überzeugung ~ Die Überzeugungen
Rover – Der Rover ~ Die Rover
Wren – Der Zaunkönig ~ Die Zaunkönige
Compound – Die Verbindung ~ Die Verbindungen
Expedition – Die Expedition ~ Die Expeditionen
Reward – Die Belohnung ~ Die Belohnungen
Pillar – Die Säulen ~ Die Säulen
Jam – Die Marmelade ~ Die Marmeladen
Brandy – Der Schnaps ~ Die Brände
Residence – Die Residenz ~ Die Residenzen
Baron – Der Baron ~ Die Barone
Enterprise – Das Unternehmen ~ Die Unternehmen
Complex – Der Komplex ~ Die Complexs
Candidate – Der Kandidat ~ Die Kandidaten
Triumph – Der Triumph ~ Die Triumphes
Twist – Die Wendung ~ Die Drehungen
Sketch – Die Skizze ~ Die Skizzen
Register – Das Register ~ Die Register
Heartbeat – Der Herzschlag ~ Die Herzschläge
Cafeteria – Die Cafeteria ~ Die Cafeterien
Fee – Die Gebühr ~ Die Gebühren
Hillside – Die Hang ~ Die Hänge
Maze – Das Labyrinth ~ Die Labyrinthe
Fisherman – Der Fischer ~ Das Fishermans
Hum – Das Brummen ~ Die Summt
Kitten – Das Kätzchen ~ Die Kätzchen
Dread – The Dread ~ Die Dreads
Substance – Die Substanz ~ Die Substanzen
Melody – Die Melodie ~ Die Melodien
Bang – Der Knall ~ Der Pony
Dagger – Der Dolch ~ Die Dolche
Intent – Die Absicht ~ Die Absichten
Con – Das Con ~ Die Nachteile
Loneliness – Die Einsamkeit ~ Die Einsamkeiten
Motorcycle – Das Motorrad ~ Die Motorräder
Amazement – Das Staunen ~ Die Amazements
Peer – Die Peer ~ Die Peers
Tech – Die Tech ~ Die Teches
Insult – Die Beleidigung ~ Die Beleidigungen
Capacity – Die Kapazität ~ Die Kapazität
Awe – Die Ehrfurcht ~ Die Awes
Chili – Die Chili ~ Die Chilis
Lodge – Die Lodge ~ Die Logen
Clip – Der Clip ~ Die Clips
Limo – Die Limousine ~ Die Limousinen
Mosquito – Die Mücke ~ Die Mücken
Dice – Der Würfel ~ Die Würfel
Shake – Der Shake ~ Die Shakes
Feast – Das Festmahl ~ Die Feste
Casino – Das Casino ~ Die Casinos
Pea – Die Erbse ~ Die Erbsen
Murmur – Das Murmeln ~ Das Murmeln
Conflict – Der Konflikt ~ Die Konflikte
Stem – Der Stamm ~ Die Stiele
Comrade – Der Genosse ~ Die Genossen
Flock – Die Herde ~ Die Herden
Sob – Sob ~ Das Schluchzen
Pregnancy – Die Schwangerschaft ~ Schwangerschaften
Suspect – Der Verdächtige ~ Die Verdächtigen
Coincidence – Das Zusammentreffen ~ Die Zufälle
Ranger – Der Waldläufer ~ Die Ranger
Cartoon – Die Karikatur ~ Die Karikaturen
Roommate – Der Mitbewohner ~ Die Mitbewohner
Kindness – Die Freundlichkeit ~ Die Freundlichkeiten
Cruiser – Der Kreuzer ~ Die Kreuzer
Slab – Die Bramme ~ Die Brammen
Conscience – Das Gewissen ~ Das Gewissen
Cheer – Die Cheer ~ Der Jubel
Cone – Der Konus ~ Die Kegel
Circuit – Die Schaltung ~ Die Schaltkreise
Ivory – Das Elfenbein ~ Die Elfenbeinarbeiten
Carpenter – Der Zimmermann ~ Die Zimmerleute
Realm – Das Reich ~ Die Reiche
Bum – Der Penner ~ Die Bums
Donna – Die Donna ~ The Donnas
Reservation – Die Reservierung ~ Reservierungen
Entertainment – Die Unterhaltung ~ Die Unterhaltungen
Crab – Die Krabbe ~ Die Krabben
Groan – Das Stöhnen ~ Das Stöhnen
Academy – Die Akademie ~ Die Akademien
Longing – Die Sehnsucht ~ Die Sehnsüchte
Kip – Die Kip ~ Die Kips
Drill – Der Bohrer ~ Die Bohrer
Luggage – Das Gepäck ~ Die Den Gepäck
Canopy – Der Baldachin ~ Die Baldachine
Thrill – Der Nervenkitzel ~ Den Nervenkitzel
Virtue – Die Tugend ~ Die Tugenden
Marsh – Der Sumpf ~ Die Sümpfe
Chimney – Der Schornstein ~ Die Schornsteine
Anchor – Die Anker ~ Die Anker
Harmony – Die Harmonie ~ Die Harmonien
Maple – Das Ahorn ~ Die Ahorne
Bunny – Das Kaninchen ~ Die Hasen
Mode – Der Modus ~ Die Modi
Throne – Der Thron ~ Die Throne
Application – Der Antrag ~ Anwendungen
Physics – Die Physik ~ Die Physicsies
Neon – Das Neon ~ Die Neons
Airlock – Die Luftschleuse ~ Die Luftschleusen
Fatigue – Die Ermüdungs ~ Die Strapazen
Thanksgiving – Die Danksagung ~ Die Danksagungen
Manuscript – Das Manuskript ~ Die Handschriften
Basis – Die Basis ~ Die Basises
Memorial – Das Denkmal ~ Gedenkstätten
Cupboard – Der Schrank ~ Die Schränke
Leap – Der Sprung ~ Die Sprünge
Japanese – Die Japaner ~ Die Japaneses
Engineering – Das Engineering ~ Die Engineerings
Left – Die Linke ~ Die Linke
Ache – Der Schmerz ~ Die Schmerzen
Bronze – Die Bronze ~ Die Bronzen
Association – Die Assoziation ~ Die Verbände
Fleet – Die Flotte ~ Die Flotten
Marker – Der Marker ~ Die Marker
Prey – Die Beute ~ Die Beute
Dove – Die Taube ~ Die Tauben
Grasp – Der Griff ~ Die Griffe
Episode – Die Episode ~ Die Episoden
Origin – Der Ursprung ~ Die Ursprünge
Vacuum – Das Vakuum ~ Die Staubsauger
Cathedral – Die Kathedrale ~ Die Kathedralen
Management – Das Management ~ Die Unternehmensleitungen
Down – Die Nach Unten ~ Die Tiefen
Continent – Der Kontinent ~ Die Kontinente
Dickens – Zum Teufel ~ Die Dickenses
Volunteer – Die Freiwillige ~ Die Freiwilligen
Soccer – Fußball ~ Die Soccers
Hem – Der Saum ~ Die Säume
Mention – Die Erwähnung ~ Nennungen
Lust – Die Lust ~ Die Begierden
Giggle – Die Kichern ~ Das Kichern
Classmate – Die Klassenkameraden ~ Die Klassenkameraden
Cleaning – Die Reinigung ~ Die Reinigungen
Receptionist – Der Rezeptionist ~ An Der Rezeption
Caller – Der Anrufer ~ Die Anrufer
Pursuit – Das Streben ~ Die Beschäftigungen
Contempt – Die Verachtung ~ Die Geringschätzungen
Sacrifice – Das Opfer ~ Die Opfer
Grandparent – Die Großeltern ~ Die Großeltern
Threshold – Der Grenzbereich ~ Die Schwellen
Deed – Die Tat ~ Die Taten
Countryside – Die Landschaft ~ Die Landschaften
Artifact – Das Artefakt ~ Die Artefakte
Wrinkle – Die Falten ~ Die Falten
Magician – Der Magier ~ Die Zauberer
Pang – Der Stich ~ Die Stiche
Italian – Die Italienische ~ Die Italiener
Eternity – Die Ewigkeit ~ Die Ewigkeit
Slate – Der Schiefer ~ Die Schiefertafeln
Stairwell – Das Treppenhaus ~ Die Treppenhäuser
Announcement – Die Ankündigung ~ Die Ankündigungen
Motive – Das Motiv ~ Die Motive
Mechanic – Der Mechaniker ~ Die Mechanik
Ally – Der Verbündete ~ Alliierten
Vase – Die Vase ~ Die Vasen
Salesman – Der Verkäufer ~ Die Salesmans
Therapist – Der Therapeut ~ Die Therapeuten
Granny – Die Oma ~ Die Omas
Maverick – Der Außenseiter ~ Die Mavericks
Bandage – Die Bandage ~ Die Bandagen
Ham – Der Schinken ~ Die Schinken
Carter – Der Fuhrmann ~ Die Fuhr
Investment – Die Investition ~ Die Investitionen
Appeal – Die Beschwerde ~ Die Rechtsmittel
Innocence – Die Unschuld ~ Die Innocences
Calendar – Der Kalender ~ Die Kalender
Rooftop – Die Dach ~ Die Dächer
Combat – Der Kampf ~ Die Kämpfe
Revelation – Die Offenbarung ~ Die Enthüllungen
Pancake – Der Pfannkuchen ~ Die Pfannkuchen
Asteroid – Der Asteroid ~ Die Asteroiden
Postcard – Die Postkarte ~ Die Postkarten
Garment – Das Kleidungsstück ~ Die Kleidungsstücke
Determination – Die Bestimmung ~ Die Bestimmungen
Tractor – Der Traktor ~ Die Traktoren
Berry – Die Beere ~ Die Beeren
Surroundings – Die Umgebung ~ Die Surroundingses
Clump – Der Klumpen ~ Die Klumpen
Offense – Die Straftat ~ Die Straftaten
Introduction – Die Einleitung ~ Die Einleitungen
Butler – Der Butler ~ The Butlers
Cough – Der Husten ~ Die Coughes
Granite – Der Granit ~ Die Granite
Ambassador – Der Botschafter ~ Die Botschafter
Turning – Der Wende ~ Die Späne
Sitting – Die Sitzung ~ Die Sitzungen
Compliment – Das Kompliment ~ Die Komplimente
Carton – Der Karton ~ Die Schachteln
Doorbell – Die Türklingel ~ Die Türklingeln
Certainty – Die Gewissheit ~ Die Gewissheiten
Politician – Der Politiker ~ Die Politiker
Gratitude – Die Dankbarkeit ~ Die Danksagungen
Current – Die Jetzige ~ Die Ströme
Gloom – Das Dunkel ~ Die Düsterkeit
Plaster – Der Putz ~ Die Pflaster
Settlement – Die Siedlung ~ Die Siedlungen
Chop – Die Chop ~ Die Koteletts
Homicide – Die Mordkommission ~ Die Tötungsdelikte
Aluminum – Die Aluminium ~ Die Aluminums
Boulevard – Der Boulevard ~ Die Boulevards
Pupil – Der Schüler ~ Die Schülerinnen Und Schüler
Float – Der Schwimmer ~ Die Schwimmer
Profession – Der Beruf ~ Berufe
Retreat – Der Rückzug ~ Die Exerzitien
Intersection – Der Schnittpunkt ~ Die Schnittpunkte
Scheme – Die Regelung ~ Die Systeme
Emptiness – Die Leere ~ Die Emptinesses
Publisher – Der Verlag ~ Die Verleger
Circus – Der Zirkus ~ Die Zirkusse
Dimension – Die Abmessung ~ Die Dimensionen
Zoo – Der Tierpark ~ Die Zoos
Sickness – Die Krankheit ~ Die Krankheiten
Messenger – Der Bote ~ Die Boten
Beau – Das Beau ~ Die Beaus
Tangle – Das Gewirr ~ Die Tangles
Personnel – Das Personal ~ Die Personnels
Strategy – Die Strategie ~ Die Strategien
Desperation – Die Verzweiflung ~ Die Verzweiflungen
Businessman – Der Geschäftsmann ~ Die Business
Pod – The Pod ~ Die Schoten
Drain – Der Abfluss ~ Die Drain
Strawberry – Die Erdbeere ~ Die Erdbeeren
Anniversary – Der Jahrestag ~ Die Jahrestage
Binoculars – Das Fernglas ~ Die Binocularses
Gulf – Die Kluft ~ Die Buchten
Discipline – Die Disziplin ~ Die Disziplinen
Hedge – Die Hecke ~ Die Hecken
Moan – Das Stöhnen ~ Das Stöhnen
Income – Das Einkommen ~ Die Einkommen
Myth – Der Mythos ~ Die Mythen
Shutter – Der Verschluss ~ Die Fensterläden
Raft – Das Floß ~ Die Flöße
Physician – Der Arzt ~ Die Ärzte
Ambition – Der Ehrgeiz ~ Die Ambitionen
Camel – Das Kamel ~ Die Kamele
Beating – Das Schlagen ~ Die Schläge
Acid – Die Säure ~ Die Säuren
Cereal – Müsli ~ Getreide
Basin – Das Becken ~ Die Becken
Nightgown – Das Nachthemd ~ Die Nachthemden
Internet – Das Internet ~ Die Internets
Cockpit – Das Cockpit ~ Die Cockpits
Wreck – Das Wrack ~ Die Wracks
Wig – Die Perücke ~ Die Perücken
Rein – Darin ~ Die Zügel
Recorder – Der Recorder ~ Die Rekorder
Pork – Das Schweinefleisch ~ Die Porks
Hound – Der Hund ~ Die Hunde
Boundary – Die Grenze ~ Die Grenzen
Exam – Die Prüfung ~ Die Prüfungen
Courtesy – Die Höflichkeit ~ Die Höflichkeiten
Assistance – Die Hilfe ~ Die Unterstützungen
Cheekbone – Die Wangenknochen ~ Die Wangenknochen
Whip – Die Peitsche ~ Die Peitschen
Pilgrim – Der Pilger ~ Die Pilger
Grease – Das Fett ~ Die Fette
Collapse – Der Kollaps ~ Die Zusammenbrüche
Faculty – Die Fakultät ~ Die Fakultäten
Reminder – Die Erinnerung ~ Die Erinnerungen
Sage – Der Weise ~ Die Weisen
Asphalt – Der Asphalt ~ Die Asphalte
Privilege – Das Privileg ~ Die Privilegien
Stairway – Das Treppenhaus ~ Die Treppen
Maintenance – Die Wartung ~ Die Wartungen
Sweetie – Die Süße ~ Die Süßigkeiten
Orchard – Der Obstgarten ~ Die Obstgärten
Cot – Das Kinderbett ~ Die Kinderbetten
Pouch – Der Beutel ~ Die Taschen
Lighter – Das Feuerzeug ~ Die Feuerzeuge
Kitty – Die Katze ~ Die Kätzchen
Formation – Die Formation ~ Die Formationen
Snack – Die Snack ~ Die Snacks
Talking – Das Reden ~ Die Gesprächen
Op – Die Op ~ Die Ops
Shriek – Der Schrei ~ Die Schreie
Sculpture – Die Skulptur ~ Die Skulpturen
Chairman – Der Vorsitzende ~ Die Chair
Sum – Die Summe ~ Die Summen
Carrot – Die Karotte ~ Die Karotten
Ripple – Die Welligkeit ~ Die Wellen
Stripe – Der Streifen ~ Die Streifen
Cavern – Die Höhle ~ Die Höhlen
Radar – Die Radar ~ Die Radare
Ponytail – Der Pferdeschwanz ~ Die Pferdeschwänze
Designer – Der Designer ~ Die Designer
Surge – Die Stoß ~ Die Überspannungen
Heir – Der Erbe ~ Die Erben
Vault – Der Bunker ~ Die Gewölbe
Sissy – Die Sissy ~ Die Weicheier
Scotch – Die Schotten ~ Die Bremsschuhe
Stillness – Die Stille ~ Die Stillnesses
Tunic – Die Tunika ~ Die Tuniken
Think – Der Think ~ Das Denkt
Penis – Der Penis ~ Die Penisse
Native – Der Einheimische ~ Die Eingeborenen
Lovemaking – Das Liebesspiel ~ Die Lovemakings
Aide – Der Adjutant ~ Die Helfer
Bulk – Der Großteil ~ Die Massen
Poker – Die Poker ~ Die Poker
Lime – Der Kalk ~ Der Limes
Surveillance – Das Überwachungs ~ Die Anwendungsbeobachtungen
Assembly – Die Versammlung ~ Die Baugruppen
Grandson – Der Enkel ~ Die Enkel
Chopper – Der Chopper ~ Die Zerhacker
Carrier – Der Träger ~ Die Träger
Engagement – Die Verlobung ~ Die Engagements
Kin – Das Kin ~ Die Kins
Mum – Die Mama ~ Die Mütter
Lighting – Die Beleuchtung ~ Die Beleuchtung
Fit – Die Passform ~ Die Anfälle
Pull – Die Pull ~ Die Zieht
Verge – The Verge ~ Die Seitenstreifen
Farmhouse – Das Bauernhaus ~ Die Bauernhäuser
Wait – Das Warten ~ Die Wartezeiten
Assassin – Der Attentäter ~ Die Attentäter
Foam – Der Schaum ~ Die Schäume
Tug – Der Schlepper ~ Die Schlepper
Journalist – Der Journalist ~ Die Journalisten
Recording – Die Aufnahme ~ Die Aufnahmen
Cure – Die Heilung ~ Die Heilungen
Descent – Der Abstieg ~ Die Abfahrten
Ringing – Das Klingeln ~ Die Ringings
Scissors – Die Schere ~ Die Scissorses
Twig – Der Zweig ~ Die Zweige
Resort – Der Urlaubsort ~ Die Ferienorte
Guardian – Der Beschützer ~ Die Wächter
Opponent – Der Gegner ~ Die Gegner
Chef – Der Küchenchef ~ Die Köche
Wheat – Der Weizen ~ Die Weizen
Hurricane – Der Hurrikan ~ Die Hurrikane
Playground – Der Spielplatz ~ Die Spielplätze
Mushroom – Der Pilz ~ Die Pilze
Keyboard – Die Tastatur ~ Die Keyboaries
Cedar – Die Zeder ~ Die Zedern
Crest – Das Wappen ~ Die Kämme
Jasmine – Der Jasmin ~ Die Jasmin
Armchair – Der Sessel ~ Die Sessel
Attraction – Die Attraktion ~ Attraktionen
Blind – Blinde ~ Die Blinds
Cylinder – Zylinder ~ Die Zylinder
Swallow – Die Schwalbe ~ Die Schwalben
Celebrity – Die Berühmtheit ~ Die Prominenten
Wilderness – Die Wildnis ~ Die Wildnis
Triangle – Das Dreieck ~ Die Dreiecke
Stench – Der Gestank ~ Die Gestank
Laboratory – Das Labor ~ Die Laboratorien
Array – Das Array ~ Die Arraies
Valentine – The Valentine ~ Die Valentines
Retirement – Das Renten ~ Die Pensionierungen
Ski – Der Ski ~ Die Skier
Edition – Die Ausgabe ~ Die Ausgaben
Supervisor – Der Supervisor ~ Die Aufsichtsbehörden
Expanse – Die Weite ~ Die Weiten
Ending – Das Ende ~ Die Endungen
Moss – Das Moos ~ Die Moose
Gale – Der Sturm ~ Die Stürme
Loyalty – Die Treue ~ Die Loyalitäten
Lavender – Der Lavendel ~ Die Lavendel
Pardon – Die Begnadigung ~ Die Begnadigungen
Ashtray – Der Aschenbecher ~ Die Aschenbecher
Shard – Die Scherbe ~ Die Scherben
Corporation – Das Unternehmen ~ Die Konzerne
Distraction – Die Ablenkung ~ Die Ablenkungen
Majesty – Die Majestät ~ Die Majestäten
Pyramid – Die Pyramide ~ Die Pyramiden
Fame – Der Ruhm ~ Die Fames
Graduation – Der Schulabschluss ~ Die Unterteilungen
Distress – Die Not ~ Die Nöte
Mage – Der Magier ~ Die Magier
Independence – Die Unabhängigkeit ~ Die Unabhängigkeiten
Crush – Der Schwarm ~ Die Zermalmt
Chuckle – Das Lachen ~ Die Kichert
Dime – Die Dime ~ Die Dimes
Aim – Das Ziel ~ Die Ziele
Gust – Die Böen ~ Die Böen
Russian – Der Russe ~ Die Russen
Treat – Der Festlichkeit ~ Die Leckereien
Foreigner – Der Ausländer ~ Die Ausländer
Salary – Das Gehalt ~ Die Gehälter
Scope – Der Anwendungsbereich ~ Die Bereiche
Rebel – Der Rebell ~ Die Rebellen
Thug – Der Schläger ~ Die Schläger
Tomb – Das Grab ~ Die Gräber
Fridge – Der Kühlschrank ~ Die Kühlschränke
Socket – Die Steckdose ~ Die Buchsen
Dose – Die Dosis ~ Die Dosen
Election – Die Wahl ~ Die Wahlen
Refugee – Der Flüchtling ~ Die Flüchtlinge
Phase – Die Phase ~ Die Phasen
Pumpkin – Der Kürbis ~ Die Kürbisse
Thorn – Der Dorn ~ Die Dornen
Hide – Die Haut ~ Die Häute
Sausage – Die Wurst ~ Die Würste
Dig – Die Dig ~ Die Ausgrabungen
Tan – Der Tan ~ Die Bräunt
Loan – Das Darlehen ~ Die Kredite
Spike – Der Dorn ~ Die Spikes
Crumb – Die Krume ~ Die Krümel
Wax – Das Wachs ~ Waxs
Growl – Das Knurren ~ Die Growls
Rental – Die Vermietung ~ Vermietungen
Feed – Das Futter ~ Die Zuführungen
Escort – Die Eskorte ~ Die Begleitpersonen
Astonishment – Das Erstaunen ~ Die Erstaunlichkeiten
Flora – Die Flora ~ Die Floren
Festival – Das Fest ~ Die Feste
Debate – Die Debatte ~ Die Debatten
Critic – Der Kritiker ~ Die Kritiker
Cast – Die Besetzung ~ Die Modelle
Bloom – Die Blüte ~ Die Blüten
Loft – Das Loft ~ Die Dachböden
Commission – Die Kommission ~ Die Kommissionen
Flicker – Das Flimmern ~ Die Flackert
Economy – Die Wirtschaft ~ Die Volkswirtschaften
Radiation – Die Strahlung ~ Die Strahlungen
Bodyguard – Der Leibwächter ~ Die Bodyguaries
Realization – Die Umsetzung ~ Die Erkenntnisse
Crater – Der Krater ~ Die Krater
Voyage – Die Reise ~ Die Reisen
Congress – Das Kongress ~ Die Kongresse
Vote – Die Wahl ~ Die Stimmen
Proposal – Der Antrag ~ Vorschläge
Fry – Der Braten ~ Die Pommes
Shiver – Das Zittern ~ Gänsehaut
Obligation – Die Verpflichtung ~ Verpflichtungen
Loser – Der Verlierer ~ Die Verlierer
Instructor – Der Lehrer ~ Die Ausbilder
Wink – Die Zuzwinkern ~ Die Zwinkert
Pebble – Die Kies ~ Die Kieselsteine
Necessity – Die Notwendigkeit ~ Die Notwendigkeiten
Workshop – Der Workshop ~ Die Workshops
Sunrise – Der Sonnenaufgang ~ Die Sonnenaufgang
Exhaustion – Die Erschöpfung ~ Die Erschöpfungs
Cubicle – Die Zelle ~ Die Schränke
Double – Der Doppelgänger ~ Die Doppelgänger
Perimeter – Der Umfang ~ Die Umfänge
Comb – Der Kamm ~ Die Kämme
Finish – Das Ende ~ Die Oberflächen
Purchase – Der Kauf ~ Die Käufe
Interval – Das Intervall ~ Die Intervalle
Splash – Der Spritz ~ Die Spritzer
Convention – Die Konvention ~ Die Konventionen
Awareness – Das Bewusstsein ~ Die Gewahrsein
Pose – Die Pose ~ Die Posen
Cradle – Die Wiege ~ Die Wiegen
Ram – Der Stößel ~ Die Widder
Gentry – Der Adel ~ Die Gentries
Seam – Die Naht ~ Die Nähte
Associate – Das Assoziierte Unternehmen ~ Die Mitarbeiter
Pane – Die Scheibe ~ Die Scheiben
Punk – Der Punk ~ Die Punks
Remnant – Der Überrest ~ Die Reste
Cracker – Der Cracker ~ Die Cracker
Bluff – Der Bluff ~ Die Klippen
Dune – Die Düne ~ Die Dünen
Dentist – Der Zahnarzt ~ Die Zahnärzte
Refuge – Die Zuflucht ~ Die Schutzhütten
Satin – Die Satin ~ Die Satins
Spread – Die Verbreitung ~ Die Spreads
Entity – Das Unternehmen ~ Die Entitäten
Mailbox – Das Postfach ~ Die Mailboxs
Annoyance – Der Ärger ~ Die Ärgernisse
Hiss – Das Zischen ~ Die Zischt
Local – Das Lokal ~ Die Einheimischen
Thud – Der Bums ~ Die Schläge
Dismay – Die Bestürzung ~ Die Bestürzt
Flour – Das Mehl ~ Die Mehle
Freak – Der Freak ~ Die Freaks
Haircut – Der Haarschnitt ~ Die Abschläge
Sweet – Die Süße ~ Die Süßigkeiten
Orphan – Die Waise ~ Die Waisen
Chess – Das Schach ~ Die Chesses
Petal – Die Blütenblatt ~ Die Blütenblätter
Paperwork – Die Schreibarbeit ~ Die Papierarbeiten
Psychiatrist – Der Psychiater ~ Die Psychiater
Singing – Der Gesang ~ Die Gesänge
Interrupt – Das Interrupt ~ Die Interrupts
Examination – Die Untersuchung ~ Untersuchungen
Admiration – Die Bewunderung ~ Die Bewunderung
Freezer – Das Gefrier ~ Die Gefriergeräte
Illustration – Die Illustration ~ Abbildungen
Stew – Der Eintopf ~ Die Eintöpfe
Investigator – Der Ermittler ~ Die Ermittler
Suburb – Der Vorort ~ Der Stadtrand
Biscuit – Der Keks ~ Die Kekse
Holster – Das Holster ~ Die Holster
Factor – Der Faktor ~ Die Faktoren
Intimacy – Die Intimität ~ Die Intimitäten
Lash – Die Peitsche ~ Die Wimpern
Saving – Die Einsparung ~ Die Einsparungen
Software – Die Software ~ Die Software
Hen – Die Henne ~ Die Hennen
Birch – Die Birke ~ Die Birken
Inquiry – Die Untersuchung ~ Die Anfragen
Nursery – Der Kindergarten ~ Die Baumschulen
Transport – Der Transport ~ Die Transporte
Extent – Das Ausmaß ~ Die Ausdehnungen
Definition – Die Definition ~ Die Definitionen
Monument – Das Monument ~ Die Denkmäler
Plum – Die Pflaume ~ Die Pflaumen
Void – Das Nichts ~ Die Hohlräume
Delay – Die Verzögerung ~ Die Verzögerungen
Inspection – Die Inspektion ~ Die Inspektionen
Essence – Die Essenz ~ Die Essenzen
Cannon – Die Kanone ~ Die Kanonen
Fringe – Die Fransen ~ Die Fransen
Stereo – Die Stereo ~ Die Stereoanlagen
Fella – Die Fella ~ Fellas
Praise – Das Lob ~ Das Lob
Penguin – Der Pinguin ~ Die Pinguine
Torture – Die Folter ~ Die Qualen
Stamp – Die Briefmarke ~ Die Briefmarken
Particle – Die Partikel ~ Die Teilchen
Translator – Der Übersetzer ~ Die Übersetzer
Easter – Ostern ~ Die Easters
Freeze – Das Einfrieren ~ Die Friert
Pew – Die Pew ~ Die Bänke
Wad – Der Pfropfen ~ Die Bündel
Panties – Das Höschen ~ Die Pantieses
Consideration – Die Gegenleistung ~ Überlegungen
Spit – Der Spieß ~ Die Spieße
Cooler – Der Kühler ~ Die Kühler
Grill – Der Grill ~ Die Grills
Jug – Der Krug ~ Die Krüge
Nickname – Der Spitzname ~ Die Spitznamen
Revolver – Der Revolver ~ Die Revolver
Machinery – Die Maschinen ~ Die Maschinen
Madam – Die Damen Und Herren ~ Die Herren
Pike – Der Hecht ~ Pikes
Terrorist – Der Terrorist ~ Die Terroristen
Laptop – Der Laptop ~ Die Laptops
Offering – Das Angebot ~ Das Angebot
Beak – Der Schnabel ~ Die Schnäbel
Institution – Die Institution ~ Die Institutionen
Comparison – Der Vergleich ~ Vergleiche
Maker – Der Macher ~ Die Macher
Insight – Die Einsicht ~ Die Erkenntnisse
Sibling – Die Geschwister ~ Die Geschwister
Wardrobe – Der Kleiderschrank ~ Die Schränke
Flap – Die Klappe ~ Die Klappen
Sole – Der Einzige ~ Die Sohlen
Compassion – Das Mitgefühl ~ Die Barmherzigkeit
Ego – Das Ego ~ Die Egos
Antenna – Die Antennen ~ Die Antennen
Cricket – Die Grille ~ Die Grillen
Troll – Der Troll ~ Die Trolle
Bookstore – Der Bücherladen ~ Die Buchhandlungen
Coming – Die Ankunft ~ Das Kommen
Objection – Der Einwand ~ Die Einwände
Holder – Der Halter ~ Die Inhaber
Backseat – Rücksitz ~ Die Rücksitze
Ignorance – Die Unwissenheit ~ Die Unwissenheit
Budget – Das Budget ~ Die Budgets
Aircraft – Das Flugzeug ~ Die Flugzeuge
Corps – Das Korps ~ Die Leichen
Loaf – Das Brot ~ Die Laibe
Extension – Die Erweiterung ~ Die Verlängerungen
Freeway – Die Autobahn ~ Die Autobahnen
Solitude – Die Einsamkeit ~ Die Einsamkeit
Chemical – Die Chemische ~ Chemikalien
Villager – Der Dorfbewohner ~ Die Dorfbewohner
Perfection – Die Perfektion ~ Die Vollkommen
Pope – Der Papst ~ Die Päpste
Semester – Das Semester ~ Die Semester
Liver – Die Leber ~ Die Lebern
Saucer – Die Untertasse ~ Die Untertassen
Urgency – Die Dringlichkeit ~ Die Dringlichkeiten
Volcano – Der Vulkan ~ Die Vulkane
Spice – Die Würze ~ Die Gewürze
Hostage – Die Geisel ~ Die Geiseln
Choir – Der Chor ~ Die Chöre
Dough – Der Teig ~ Die Teigrunder
Commotion – Die Aufregung ~ Die Unruhen
Courthouse – Gerichtsgebäude ~ Die Gerichtsgebäuden
Salmon – Der Lachs ~ Die Lachse
Boxer – Der Boxer ~ Die Boxer
Errand – Die Besorgung ~ Die Besorgungen
Mechanism – Wobei Der Mechanismus ~ Die Mechanismen
Telescope – Das Teleskop ~ Die Teleskope
Ferry – Die Fähre ~ Die Fähren
Nigger – Der Nigger ~ Die Nigger
PasserBy – Der Passant ~ Die Passanten
Irritation – Die Reizung ~ Die Irritationen
Sedan – Die Limousine ~ Die Limousinen
Commitment – Das Engagement ~ Verpflichtungen
Coward – Der Feigling ~ Die Feiglinge
Git – Die Git ~ Die Gits
Flare – Die Fackel ~ Die Fackeln
Howl – Das Heulen ~ Das Heulen
Fang – Die Fang ~ Die Reißzähne
Roman – Die Römisch ~ Die Römer
Hue – Der Farbton ~ Die Farbtöne
Discomfort – Das Unbehagen ~ Die Unannehmlichkeiten
Vent – Das Entlüftungs ~ Die Lüftungsschlitze
Canoe – Das Kanu ~ Die Kanus
Recipe – Das Rezept ~ Die Rezepte
Hamburger – Der Hamburger ~ Die Hamburger
Eave – Die Traufe ~ Die Traufe
Barber – Der Barbier ~ Die Barbiere
Passing – Das Ableben ~ Die Passings
Betrayal – Der Verrat ~ Der Verrat
Sweatshirt – Das Sweatshirt ~ Die Sweatshirts
Tentacle – Die Tentakel ~ Die Tentakeln
Surf – Die Brandung ~ Die Brandungen
Plaid – Das Plaid ~ Die Plaids
Walkway – Der Gehweg ~ Die Gehwege
Limp – Das Hinken ~ Die Hinkt
Administration – Die Verwaltung ~ Die Verwaltungen
Convenience – Die Bequemlichkeit ~ Bequemlichkeiten
Diaper – Die Windel ~ Die Windeln
Mole – Der Maulwurf ~ Die Maulwürfe
Cleaner – Der Reiniger ~ Die Reinigungskräfte
Swell – Die Dünung ~ Die Schwillt
GrownUp – Der Erwachsene ~ Die Erwachsenen
Scan – Die Scan ~ Die Abtastungen
Clarity – Die Klarheit ~ Die Klarheiten
Salon – Der Salon ~ Die Salons
Producer – Der Produzent ~ Die Hersteller
Flying – Die Flug ~ Die Flusen
Plea – Der Rechtsmittelgrund ~ Die Rechtsmittelgründe
Prairie – Die Prärie ~ Die Prärien
Passport – Der Pass ~ Die Pässe
Alternative – Die Alternative ~ Alternativen
Vanity – Die Eitelkeit ~ Die Eitelkeiten
Dam – Der Damm ~ Die Dämme
Abuse – Der Missbrauch ~ Die Missbräuche
Olive – Die Olive ~ Die Oliven
Miner – Der Bergmann ~ Die Bergleute
Reserve – Die Reserve ~ Die Reserven
Backup – Die Sicherungs ~ Die Sicherungen
Intercom – Die Gegensprechanlage ~ Die Gegensprechanlagen
Shawl – Das Tuch ~ Die Schals
Platter – Der Plattenteller ~ Die Platten
Implication – Die Implikation ~ Die Auswirkungen
Rumble – Das Poltern ~ Die Rumpelt
Announcer – Der Ansager ~ Die Ansager
Rubble – Die Trümmer ~ Die Trümmern
Axe – Die Axt ~ Die Achsen
Transmission – Die Übertragungs ~ Die Übertragungen
Crib – Die Krippe ~ Die Krippen
Hop – Die Sprung ~ Der Hopfen
Graveyard – Der Friedhof ~ Die Friedhöfe
Aroma – Das Aroma ~ Die Aromen
Dialogue – Der Dialog ~ Die Dialoge
Roller – Die Walze ~ Die Rollen
Congregation – Gemeinde ~ Die Gemeinden
Terrain – Das Gelände ~ Die Terrains
Transfer – Der Transfer ~ Die Transfers
Hardware – Die Hardware ~ Die Hardwares
Generator – Der Generator ~ Die Generatoren
Luxury – Die Luxus ~ Der Luxus
Auditorium – Das Auditorium ~ Die Auditorien
Goblin – Der Kobold ~ Die Goblins
Peg – Der Zapfen ~ Die Zapfen
Defeat – Die Niederlage ~ Die Niederlagen
Haven – The Haven ~ Die Oasen
Specimen – Die Probe ~ Die Proben
Hearth – Der Herd ~ Die Feuerstellen
Admission – Die Zulassung ~ Die Zulassungs
Obsession – Die Besessenheit ~ Die Obsessionen
Launch – Der Start ~ Die Starts
Patsy – Die Patsy ~ Die Sündenböcke
Dorm – Das Wohnheim ~ Die Schlafsäle
Glen – The Glen ~ Die Täler
Saw – Die Säge ~ Die Sägen
Til – Die Til ~ Die Tils
Ape – Der Affe ~ Die Affen
Stagger – Der Staffelungs ~ Die Wankt
Pussy – Die Fotze ~ Die Fotzen
Collector – Der Sammler ~ Die Kollektoren
Earthquake – Das Erdbeben ~ Die Erdbeben
Flake – Die Flocke ~ Die Flocken
Syllable – Die Silbe ~ Die Silben
Bouquet – Das Bouquet ~ Die Blumensträuße
Selection – Die Auswahl ~ Die Selektionen
Vow – Der Schwur ~ Die Gelübde
Granddaughter – Die Enkelin ~ Die Enkel
Symptom – Das Symptom ~ Die Symptome
Scenario – Das Szenario ~ Die Szenarien
Riot – Der Aufruhr ~ Die Unruhen
Timing – Das Timing ~ Die Zeitpunkte
Burger – Der Burger ~ Die Burger
Plus – Die Plus ~ Die Pluspunkte
Sparrow – Der Spatz ~ Die Spatzen
Embassy – Die Botschaft ~ Die Botschaften
Podium – Das Podium ~ Die Podestplätze
Accusation – Der Vorwurf ~ Die Vorwürfe
Manor – Das Herrenhaus ~ Die Herrenhäuser
Shuffling – Das Schlurfen ~ Die Shufflings
Dolphin – Der Delfin ~ Die Delphine
Kettle – Der Wasserkocher ~ Die Kessel
Trooper – Der Soldat ~ Die Soldaten
Salvation – Die Rettung ~ Die Rettungen
Vet – Der Tierarzt ~ Die Tierärzte
Runway – Die Landebahn ~ Die Start Und Landebahnen
Poppy – Der Mohn ~ Der Mohn
Upstairs – Im Obergeschoss ~ Die Upstairses
Lava – Die Lava ~ Die Laven
Inspiration – Die Inspiration ~ Die Inspirationen
Bosom – Der Busen ~ Die Busen
Intruder – Der Eindringling ~ Die Eindringlinge
Supermarket – Der Supermarkt ~ Die Supermärkte
Trophy – Der Pokal ~ Die Trophäen
Jealousy – Die Eifersucht ~ Die Eifersucht
Warden – Der Aufseher ~ Des Direktors
Passageway – Der Durchgang ~ Die Durchgänge
Marina – Der Yachthafen ~ Die Jachthäfen
Farewell – Das Lebewohl ~ Die Abschiede
Belongings – Die Gegenstände ~ Der Zugehörigkeit
Procession – Die Prozession ~ Die Prozessionen
Astronaut – Der Astronaut ~ Die Astronauten
Crotch – Der Schritt ~ Die Gabelungen
Sweep – Die Sweep ~ Die Sweeps
Recovery – Die Erholung ~ Die Wiederfindungen
Harness – Der Kabelbaum ~ Die Kabelbäume
Anguish – Die Angst ~ Die Ängste
Logo – Das Logo ~ Die Logos
Litter – Der Wurf ~ Die Würfe
Marine – Die Marine ~ Die Marines
Resentment – Der Groll ~ Die Ressentiments
CoOp – Der CoOp ~ Die Genossenschaften
Drake – The Drake ~ Die Drachen
Gypsy – Der Zigeuner ~ Die Zigeuner
Imitation – Die Nachahmung ~ Die Imitationen
Employer – Der Arbeitgeber ~ Arbeitgeber
Freshman – Der Neuling ~ Die Freshmans
Phenomenon – Das Phänomen ~ Die Phänomene
Flute – Die Flöte ~ Die Flöten
Greek – Der Grieche ~ Die Griechen
Condo – Die Wohnung ~ Die Eigentumswohnungen
Forefinger – Der Zeigefinger ~ Die Zeigefingern
Burial – Das Begräbnis ~ Die Bestattungen
Republic – Die Republik ~ Die Republiken
Emerald – Der Smaragd ~ Die Smaragde
Bathrobe – Der Bademantel ~ Die Bademäntel
Testimony – Das Zeugnis ~ Die Zeugenaussagen
Hinge – Das Scharnier ~ Die Scharniere
Bakery – Die Bäckerei ~ Die Bäckereien
Context – Der Kontext ~ Die Kontexte
Bargain – Das Schnäppchen ~ Die Schnäppchen
Saying – Das Sprichwort ~ Die Sprüche
Foreman – Der Vorarbeiter ~ Die Foremans
Swan – Der Schwan ~ Die Schwäne
Flannel – Die Flanell ~ Die Waschlappen
Indication – Die Angabe ~ Die Indikationen
Significance – Die Signifikanz ~ Die Bedeutungen
Beetle – Der Käfer ~ Die Käfer
Learning – Die Lern ~ Die Erkenntnisse
Pub – Das Lokal ~ Die Pubs
Fraction – Die Fraktion ~ Die Fraktionen
Trout – Die Forelle ~ Die Forellen
Crust – Die Kruste ~ Die Krusten
Overcoat – Die Überzugs ~ Die Mäntel
Glint – Das Glitzern ~ Die Reflexen
Medal – Die Medaille ~ Die Medaillen
Perception – Die Wahrnehmung ~ Die Wahrnehmungen
Welcome – Das Willkommen ~ Die Willkommen
Dictionary – Das Wörterbuch ~ Die Wörterbücher
Metaphor – Die Metapher ~ Die Metaphern
Poverty – Die Armut ~ Die Poverties
Main – Die Haupt ~ Netz
Climb – Der Anstieg ~ Die Anstiege
Leash – Die Leine ~ Die Leinen
